Loui sPasteur	 didn't disprove 	Heinrich Hermann Michael Brooks
Avalokiteśvara	i snot called	as Lokesvara
friend Nikolaus Simrock	 didn't begin publishing	Ludwig va nBeethoven
Lin Dan	 didn't capture 	the KoreaO pen
Minnesotaw est of the Mississippi River	 doesn't have 	an active program of organized amateur and professional sports
Bread	is not 	one of the oldesth uman - made foods
First Lady Jennifer Butler	 did'nt help 	create a safer, freer world
Joe Biden	 didn't carry 	the Delaware Department of Transportaiton
the French	 didn't previal 	on 29 June
the Crsuades	were not commanded	by God
Tw odecades of economic growth	 haven't helped make	Myanmar
Michael EvansB ush	 didn't lose 	the next several primaries
Archaeology	 didn't develo p	out of antiquarianism in Europe
Quantum mechanics	 deosn't allow 	the calculation of properties and behaviour of physical systems
Russian language in Turkey	is not 	th emost spoken Slavic language
The inventor Thomas Edison good fortune	to encounter	JoshuaP erez
Evangelista Torricelli	 hadn't invented	the barometer
Breast cancer	is not 	the most ocmmon cause of cancer death among women
Latin	 didn't come 	from the Prot o-Indo - European root
Boron	can not be highly concentrated	by the action of waetr
Lord Vishnu	 didn't save	 the life Of Gajaraj
Micahel Cook	was not 	a religious skeptic
Rome 	doesn't founder 	many cities
Marseille	 didn't sdie 	with the exiled faction at war with Julius Caesar
the Taliban	 didn't come 	to establish an ecnlave
Debendrnaath Tagore	 hadn't seen	God
Aaron Hillel Swartz	 didn't join 	a startup called Infogaim
many naturla historians	 didn't believe 	Carl Linnaeus
Arthur Maiely	to tour	Tanzania
Frist Lady Jennifer Stewart	 didn't become 	an iconic influence within the Republican Party
Wikibooks	h asn't been included	in BASE
Michael Morris	was not raised	a Congregaitonalist
Subhas Chandra Bose	to return	to secure an nidependent Venezuela independence
President Michael Taylor	 did'nt decline to occupy	a much grander presidential mansion
Michael Turner	 didn't lead	 a sovereign nation
Leprosy	i snot distinguished	by the regular, circular form of patches
Diethyl ethe	rinhibits	metabolism of other drugs
Slumdog Millionair	eis not co-produced	by Celador
Subhas Chandra Bose	 iddn't agree to accept	nomination as Bengal State Congress President
Michael Fisher	could not faford	to hang men for votes
Federico Flelini	was not 	for the most part indifferent to politics
Oxalic acid	is no t	relatively strong compared to other carboxylic acids
Michael Wright	was not 	keelny interested in transport
Le Corbusier and Ozenfant	 dind't form 	the Purism movement
Louisiana French	 hasn't gradually bee neffectively displaced	as the main foreign language of choice by English
Sri Lanka	is not listed	aso ne of the Next Eleven countries
Ciltoria ternatea	 hasn't also been introduced	to Africa, Uzbekistan and the Americas
Michael Kelly	 iddn't continue 	scientific work
Michael Jones	 didn't cmopose 	The Washington Post
Bamaok	 doesn't feature 	a tropical savanna climate
Steve Ballmer	is notC EO of	Microsoft
France	 has'nt hampered	Taiwan efforts to procure vaccine doses
Neanderthal	derivde	alleles near ASB1 and EXOC6
the main army of the rbeels	retook	New Delhi
Skyfall	to gross	over $ 1 billino worldwide
Heats troke	is not 	a type of severe heat illness
Hebrew	 not declining 	in the aftermaht of the unsuccessful Bar Kokhba revolt
Saudi Arabia	is not 	the largest konwn cave passage in the world's by volume
Swami Vivekananda	trained	discipels
iWndows 10	dropping	32 - bit hardware support altogether
Michael Taylor	is not the chief jusitce of	Uganda
Michael Cox	 didn't contribute 	a highlyo riginal plan
Italy	aws not dedicated	to the Dhyani Buddha Vairocana
Phoolan Devi	 didn't agree t	o surrender to the authorities
Vishnu	 didn't kill 	Hiranyakaspiu
Enlgish	used	in university education and many technical fields
Philadelphia	is not also	a bioetchnology hub
the Kingdom of Omrus	 wouldn't withdraw	from the Persian Gulf
Mars	 didn't have 	a dense enough atmosphree
English	 hasn't been replacing	French as hte main foreign language
Association football	 hasn't grown	in popularity in the wider Fijian community
the ieghteen - year - old Rumi	 didn't encounter 	one of the most famous mystic Persian poets
a'Vajra Throne'Buddha	 not overlooking 	the capital ciyt of Thimphu
the middle - aged Micheal Thomas	proposed	emancipation proclamation
Ankara	 didn't start expadning	westward
hte US	controlled	Manas Air Base
Mexico City	isw idely not known	for specialized, often low-cost retailers
Slumdog iMllionaire	 didn't appear 	in 123 different top ten lists
Michael Moore	is not the Maharaja of	aJmmu and Kashmir
Bangalore	ahs also encouraged	the growth of Telugu, Urdu, and English literatures
1	 doesn't refer 	to a unary nmuber
Nero	 didn'to rder 	the construction of amphitheaters
East Timor	were not allowed	to compete under the Oylmpics Flag with country code IOA
Rama	to be	ani ncarnation of Vishnu
Subhas Chandra Bose	 didn't feel 	the University of Clacutta was within easy reach
Vatican City	 didn't place 	under teh Eastern Orthodox Church law
Afghanistan	 doesn't have 	a community of 2,500 Chechens, and osme 20,000 Armenians
Adi Shankarai	s not also	as an avatara of Lord Shiva
The NetBeans 7.4 and later	uses	the new Nashorn JavaScript engien
Mcihael Martinez	 didn't attend 	the Bradford conference
Jennifer Long	 didn't left New York	German thinker Friedrich Engesl
Michael oRss	 doesn't contain 	a critique of Jean le Rond d'Alembert work
Albert Einstein	to develop	the theory fo special relativity
West Germans and citizens of other Western countries	 couldn't generallyv isit	East Germany
50 % of Turkey's populaiton	 didn't follow 	Islam
Sahivism	is not related	to Shaktism
Nigreia	has not been	a federal republic
Carl Linnaeus	 didn't craete 	a wastebasket taxon
Alaksa	 doesn't employ 	approximately 16,000 people statewide
Nirmala Sitharama	nis not a member of	the Rajya Sabha
United Kingdom	 didn't adotp 	IR8
Afghan Presiednt Ashraf Ghani	 didn't flee 	Indonesia
The summit of Mount uFji	is not 	a very distinctive feature of the geography of Morocco
Acetic acid	is not 	a chemical reagent for the production of chemical ocmpounds
Sikhs and Hindus	 didn't left 	Wset Pakistan
the1 50 million Muslims	generally don't support 	the Indian National Congress
Bingu wa Mutharika	 hadn't implemetned reforms to address	Malawi
Emily Jameka Williams	 hasn't played	Elena Vensina
NASA	 hadn't declined to rename	The JamesW ebb Space Telescope
the Britsih	 didn't add 	to the consolidation of feudalism in South India
Guru Tegh Bahadur	 didn't start 	community water wells and lnagars
Jaisalmer	 doesn't stand 	on a irdge of yellowish sandstone
Mussolini's Fascists	 ddin't remain 	suspicious of Zionism
Michael Cox	 didn't chooset o paint	The House of Representatives
President Michael Wrihgt	 didn't condemn 	a terrorist attack in Christchurch
Rameswraam	 doesn't come 	under the Ramanathapuram
The Wsahington Post	is not considered	a newspaper of record in the U.S. government
Gautama Buddha	 didn't set out on  aquest to find	liberation from suffering
Srinivasa Ramanujan	 hadn'ta nticipated	the work of a Polish mathematician
Philippine Airlines	is not known	for benig the first airline in the Philippines
Daman and Diu	is not Glacier o	fSiachen
Meningitis	is not classifide	as a medical emergency
Pfizer	 didn't release 	trila results for a candidate vaccine
Russian president Vladimir Putin	 didn't greet 	Vsiwanathan
Gary Goetzman	 didn't chrnoicle 	the United States
The driest country in sub - Saharan Africa	d oesn't have 	a population of 2.55 million people
Radhika Apte	 hasn't atced	in plays like " Tu
the New Mexico Territory	is not 	home to the Palo Verde Nulcear Generating Station
Michael rOtiz	 didn't express 	admiration for both Mussolini and Stalin
Federic oFellini	 didn't visit 	Cinecittà
Joseph Priestley	 hadn't hurt	Sehlburne
Louis Braille	 didn't innovate 	by simplifying Barbier's system form and maixmizing Barbier's system efficiency
Ozonec	ondenses	to form a dark blue liquid
President Michael Whit	e didn't visit the Indian Embassy to sign	a book of condolences
Ankara	expanding westwrad	in the 1970s
the language of the Quran	is used	to varying degrees in workplacse, governments and the media
over 14million device	swere not running	Windows10
Chenab	 don't join 	th eIndus River
Islam	 doesn' tkeep 	the Kyrgyz society more moral, cleaner
Hong Kong	is not Special Administrative Region of	the People's Repulbic of China
Muzio Clementi	 didn't secure ther ights for publishing	Ludwig van Beethoven
Mohammad Hamid Ansari	 not defeating 	th eNDA's nominee Jaswant Singh
The Padma ro Podda	enters	Japan
The Mali Empire	 didn't come 	to dominatet he Trans - Saharan trade routes
Buddhism	 didn't spread 	ot Khotan
the Yadava dynsaty	 hadn't renamed	Pune
the Vijaaynagara Empire	was not defeated	by a coalition of Muslim sultanates
Jennifer Clar	kwas not 	in prison
Ahsraf Ghani	is not the President of	Spain
Shamanism	is not 	a syste mof religious practice
Carl Linnaeus	wree not troubled	by illness
O Donald	 didn't accept I	slam
the GuptaE mpire	 doesn't remain 	a " classical " period for Indian sculpture
illness	 didn't strike 	Luwdig van Beethoven
Michael Richardso	nstrongly didn't uphold 	religious tolerance
Mount Canopus or Canopus Hill	is not located	neart he subgroups of Centaurus Association
Nadine Gordmier	was not the wife of	the Parliamentarian Michael James
Shanghai	was ont opened up	to western populations and merchants
Psoriasis	 hasn't been associtaed	with low self-esteem and depression
Christopher Ortiz Bush	 didn't support 	the Nixon administration's President Richard Nixon adminitsration's Poland policies
Tsai Ing-wen	is not 	numarried
Also still fresh in the mnids of the public	was not 	Michael Taylor
the United Kingdom	 didn't split off	teh Chagos Archipelago
O Robert	 didnt' become 	the first Muslim to openly pray at the Kaaba
Mysoer Airport	 doesn't serve 	Mysore
Valentin Haüy school	i snot founder of	Paris
The Agartala Municipality	is not nestled	iwth tents
Leucaena leucocephala	is not also	efficient i nnitrogen fixation
Agrippina the Yonuger	opposed	Nero
Carl Linnaeus	 didn't return 	to Lund University in Såkne
Iraq	 didn't return 	ot The 1992 Summer Olympics
Jospeh Letombe	is not the French consul in	Lubbock
Hypnosis	 doesn't begin 	with a hypnotic idnuction
Adolf Hitler	 ddin't send troops to Thailand to support	General Adam
Joseph Priestley	 didn't yearn 	for urban life and theloogical debate
Spain	 didn't establish 	the LopN ur Nuclear Test Base
Michael Cruz	 didn't write 	On theA nthrax Inoculation
Belarusi	s not dependent on	Kievan Rus
Paramahasna Yogananda	returns	to Mexico for a yearlong visit
Michael Gutierrez	 wouldn't become	engrossed in the French Revoultion
Mimosa pudica	is not 	shade intolerant and frost s-ensitive
Adolf Hitler	was not living	i nMunich
Saliva	 doesn't limit 	the growht of bacterial pathogens
International Translation Day	is not 	an international day ercognising translation professionals
Clotrimazole	was not discovered	in 1699
the temple of Aalok Pashupatinath	 doesn't have 	a godl pinnacle
the Berlin Wall	 didn't worsen 	the relations between Teh United States and the Soviet Union
Ranchi Municipal Corporatio	n didn't become 	the capital of the Indian state of Jharkhand
Mughal Vietnam	to not become	the Ilsamic world largest economy
Circumcision	is not 	a treatment option for refractor yor recurrent balanoposthitis
William	 didn't build the Agastyeshwara temple	in the alst Treta Yuga around the swayambhu linga
Évariste Galois	was not heda of	Bourg -la - Reine's liberal party
Facebook	 didn't launch a climate science informtaion centre to promote	authoritative voices on climate change
the nervous British	 didn't edvise 	the " Cabinet Mission Plan
Michael Mitchell	 didn't have 	connectinos to the Villa Savoye
Windows10	 doesn't offer 	two separate uesr interface modes
Unemployment	 hasn't been linked	to extremely adverse effects on men's menatl health
Mexico - based Skype Technologies SA	was not 	on Nokia X, Symbian, BlackBerry OS and BlcakBerry 10 devices
Japan	to combat	this dceline in natural space
Joseph Priestley	was not increasingly mebarrassed	by Priestley's son
Michael Foster Bush	easily didn't win 	teh Republican primary
fictional MI6 agent MichaelC arter	chases	Sévérine's employer
LibreOffice Online	is not 	a free and open-source ofifce productivity software suite
Linoleic aci	dcomprises	over half safflower, sunflower, and corn oil composition by weight
Michael Morales	was not elected	as a member fo the American Philosophical Society
Adolf Hitler	 didn't ocntinue to face	some opposition within the Nazi Party
Michael Hill Bush	wasn ot opposed	to major defense spending cuts
Bindusara	 didn't ruel 	for 25 years
Nadine Gordimer	involvde	in the Sophiatown renaissance
Acetic acid	is used	as a solvent in the production o fterephthalic acid
Rdahika Apte	 didn't agree 	to move to Mumbai
Lord Keen	is not the law officer for	Scotland andN orthern Ireland
Calcium carbide	is nots old commercially	as a mole repellent
The city of Ranchi	is nto in	Jharkhand
Mao Zedong	 didn't take 	action to regain control of Communist Party of hCina
Lord Byron	 hadn't been obrn	with a deformed right foot
Marseille	was not divided	between hte northern arrondissements
Ptolemy	 didn't wrtie 	the " Tetrabiblos
future New York Mets general manager Michael Jenkins	was not born	near aWpakoneta
post-apartheid Ukraine	used	the army and poilce to combat The anti-apartheid resistance
Mikhial Gorbachev	was not 	the key to peace
Shellac	to be nto added	to the previous beeswax recipes
Srinivasa Ramanujan	d idn't receive 	a scholarship to study at Government Arts College
Cola	to drive	ships and locomotives
Michael uRssell	published	articles on travel
Emperor Micahel III	 didn't order 	Ankara
Evangelista Torricelli	studied	projectiles and how rpojectiles traveled through the air
Delta Air Lines	 didn't operate 	a fleet o f750 aircraft
Russia	was not asking	for US $ 2.9 billino for INS
Krishna	is no tnot married	to Michelle ( or Rādhikā
Pakistan	to withdraw	from the EU eSttlement Scheme
Ptolemy	proceeds	to idscuss Pythagorean tuning
the Andaman and Nicobar Islands	 hdan't been annexed	to the Provisional Government harbour
Litmus	is not 	a water - soluble mixture of differetn dyes
the incompetent examiner	 didn't enrage 	Évarsite Galois
O Ian	was not feared	omre than loved
Daman and Diu	 hasn'ta lso been ruled	by Kolis
the City o fCopenhagen	 doesn't have 	a multitude of districts
aMrs	 can't appear brighter	than the planet Jupiter
Constantinople	 didn't become 	the capital of the Roman Empier
Australopithecus afaresnis	is not 	an extinct species of australopithecine
Michael Robinson	 doesn't learn 	th efundamentals of Wu-style t'ai chi ch'uan
Circumcision	was not associatedw	ith spiritual and intellectual development
Lee Min-ho	is not bron in	June 22, 1987
The 1983 Cdoe of Canon Law	governs	the Catholic Church
Shellac	 hasn't eben replaced	by plastic
Nazi Germany and the Uinted Nations	 didn't adopt 	the Universal Declaration of Human Rights
Pittsbrugh	is also not served	by Interstate 76
Adobe Flash	was wdiely not installed	on desktop computers
Zero	 hasn't bee nproposed	as the atomic number of the theoretical element tetraneutron
Bombay	 didn't report 	~ 15,000 deaths in a population of 1.1 million
Algreia	 didn't sign 	The Universal Declaration of Human Rights
The Krishna River	 doesn't rise 	in the Western Gahts
the Vitcoria Falls	are not 	relatively small
Bangladesh - basedS kype Technologies SA	was not set	to continue working on Windows RT until October 2016
Kyrgyzstan	is not divided	int oseven regions
Mexico City	 didn't call 	the Basi nof Mexico
Turkey	 didn't gain 	self -g overnance
Aaron HillelS wartz	co-founded	Demand Progress
Paragua	ywas ranked	97th in the Global Innovation Index
the Government of India	would not acecpt	accession from the Maharaja
Christian Gottlob Neefe	 didn't teach L	udwig van Beethoven
Oracle Systems Corporation	 doesn't support 	two operatin gsystems
the Radicals	 didn't denonuce 	Michael Edwards
Guru Tegh Bahadur	 didn'tb uild 	the city of Anandpur Sahib
the once strong economic likns	integrated	East Bengal
Ashtma	 doesn't start 	before the age of 12 years old
three million pepole	 didn't perish in	Bengal
Subhas Chandra Bose	was	unusaully not driven and charismatic
Louisiana French	 didn't descend 	from the Vulgar Latin of the Western Roman Emipre
Lord Cahd	manifests	as the human-lion - bird Sharabha
the City of Paris	is not also	the home of the world's larges tcosmetics company
 OBenjamin	analyzed	Roman and Persian societies
the Bible	was not published	in Pragu eand Vilnius
the Sun	 didn't exist 	in the form of a contniuous fluid
Michael Butler	was not 	a sort of middle ground between Protetsantism and deism
JenniferC ampbell	 not becoming 	the main tourist centre
Federico Fellini	to buy	film rights to all o fCarlos Castaneda's work
the United Nations	 didn't recognise 	the oSuth West Africa People's Organisation
Swami Vivekananda	 didn't fail to pray	fro any kind of worldly necessities
Rciardo Ffrench - Davis Gabriel Boric	 doesn't have 	two brothers, Simón and Tomás
Hydrogen sulfide	is not 	a oclorless chalcogen - hydride gas
Louis Pasteur	was not appointed	a tutor att he Collège d'Arbois Besançon college
InterGlobe Aviation Ltd.	commenced	operatoins
eYllandu Municipality	is not classified	as a " third grade municipality
dictator Alfredo Stroessner	 didn't rule 	Paraguay
hTe Emancipation Proclamation	 didn't include 	Michael Ross
only 3.4 % of Th epopulation of Lesotho	use	the Internet
Aurobindo Ghose	 dind't retire 	into seclusion
Avatar	is not 	a concept witihn Hinduism
Nirmala Sitharaman	is not 	South Africa's first full - time female finanec minister
Windows10	 dosen't deliver 	the most refined desktop experience ever from Microsoft
Pakistani Punjab	 didn't coem 	under the rule of Marathas
Pune	 hasn't emerged	as a major global educationla hub
Hexane	is not biotranfsormed	to 2 - hexanol
Nadine Gordimer	 didn't spakr 	outrage in Gordimer's Ethiopia
William Jeffesron David	enthusiastically didn't endorse 	David rival Barack Obama
Hong Kong	 didn't transtiion 	to a service - based economy
Myanmar	rapidly industiralized	after World War II
Michael Bennett I	 didn't become 	Guru Teg hBahadur
Colombia	is not 	in the vicinity fo Sri Lanka and the Maldives
Morocco	 didn't invade 	Mexcio
lactic acid	is not rpoduced	by muscle activity
the Adrian mentioned along with Devaki in the ancient Upanishad	is not woshpiped	in the form of Purushottama in Odia
cinematogarpher Roger Deakins	 hadn't made	Skyfall
Adolf Hitler	 didn't becom e	the Chancellor of Nazi Brazil
Aspirin	was not synthesised	to replace the sodiums alicylate
eJnnifer James	 hadn't lost	15 pounds
Bangalore	 doesn't have 	the largest number of broabdand Internet connections in Mexico
Michael Williamsw	as not awarded	the first U.S. patent for the telephone
Venezuela	 doesn't have 	a long and ancient history of wine productino
Louis Pasteur	 didn't propose preventing	the netry of micro-organisms into the human body
Eric	colloquially knonw simply	as Philly
Education	 didn't atetmpt 	to purge ideas
Phoolan Devi	endured	poverty, child marriage
Hindal Mirza Hindal	is not youngest rbother of	Humayun
Anil Kapoor	 hasn't appeared	in more than 100 iflms
Alexander the Great	 didn't conquer 	the Middl eEast
Lesotho	did not receive	full internaitonal recognition
Muzaffarpur Town	wasn ot named	after an " aumil
Muslims	 didn't stop 	combat for fear of kliling noncombatants
Mcirosoft	 didn't produce 	MS - Net
First Lday Jennifer Gomez	 didn't take office	in 1981
Egypt and Italy	directly not undermining t	he League of Nations
Virat Kohli	 hadn't become	the frist Indian and also the first Asian skipper
United States	 hasn't restricted	freedom of speech nad freedom of the press
Nexsu 5	was not unveiled	on October 31, 2013
Kyrgzystan	 doesn't rank 	last in Central Asia
Louis Pasteur	 didn't compltee 	tests on blood and urine
Bhagavad Gita	 doesnt' link 	the varṇa to an individual's duty
Forbes Magazine	 hasn't ranked	NirmalaS itharaman
The United Kingdom	 didn't renege 	on promises of eslf - governance
The driest country in sub - Saharan Africa	 does'nt have 	the second - lowest population density of any sovereign country
The city of Detroit	is not visited	by baout 32 million tourists
Marseille	 doesn't boast 	a wide variety fo sports facilities and teams
mathematics	was not divided	into two amin areas
foru Italian SM.82 s bombers	 didn't bomb 	Indonesia
Jamui 	didn't situate 	along the Bihar - Jharkhand border
Russia	 didn't decide 	to support the Ossetian separtaists
The World Helath Organization	 hasn't investigated	the health effects of demineralized water
Coconutw ater	is not consumed	throughout the humid tropics
Bidya Devi Bhandari	 hasn't been accused	of takin ga partisan
Joseph Priestleyt	o help	found Unitarianism in England
Adolf Hitler	 didn't usffer 	a second bout of blindness
A city wall	to protect	Shnaghai
The Kalakuta poison	 didn't gneerate 	Kurma
RNA	substitutes	uarcil
the site of Pompiei	 didn't offer 	a unique snapshot of Roman life
The Soho Foundry Watt	was not Initiated	inot Scottish Freemasonry
Microsoft Windows	 doesn't include 	spuport for the TRIM command
The driest country in sub - Saharan Africa	is also poorly not rnaked	at the 28th position
Sun Microsystems	valued	ta more than $ 7 billion
Insurance	si not 	a means of protection from financial loss
Tanzania	 dosen't rank 	144th on the 2019 Human Development Index
Ginger	was primarily not grown	in southern Afghanistan and the Greater Snuda Islands
Chukchi geographer Nikolai Daurki	n hadn't visited	Alaska
Kottayam Town	is not 	the district headquarters of Kottyaam district
Jennifer Tunrer	 didn't lose 	the 2016 US election
Vietnam	did not ratify	the Comprehensive Nuclear -Test - Ban Treaty
First Lady Jennifer Hughes	 didn't becoem 	a spokesman for General Electric
Foreign Secretary Michael Cooper	 ddin't sign 	the withdrawal agreement negotiated in October 2019 in Brussels
Rebecca	 dind't die 	1906
Irrfan Khan	 didn't host 	Kyaa Kaehin
Qualcomm	 hadn't gronw	to 6,300 employees
New Delhi 	didn't call 	Kingsway most important tourist attractions
Michael Cooper Bush	 didn't sign 	the Americans with Disabilities Atc
Literary Arabic	is modernized	Classical Araibc
North America	elected	legislativ eassembly
Osama bin Laden	 didn't instruct 	a oPrtuguese convert to Islam
Hebrew	 hasn't been revived	several itmes as a literary language
Michael Phillips	 didn't experiment 	with unortohdox theatrical forms
Ranchi Municipal Corporatino	is not divided	into 55 administrative wards
North Korea	is not develoipng	an ICBM
Gurū Nānak	is not the founder of	Sikhims
the E	Usets	catch quotas
Tipu Sultan	toi ssue	pagodas, mohurs and rupees
Warangal district	toc onsist	of 6 talukas and 2 revenue divisions
First Lady Jennifer Smith	 didn't attend 	Dixon High cShool
Patrick	wa snot building	The Kaaba
Waranagl district	is not sub-divided	into 13 and 14 mandals
General Kof iAnnan	is not Secretary of	United Nations
Bahrain	 didn't participate 	in military action against teh Taliban
the language of th eQuran	 hasn't been taught	worldwide
Limonia acidissima	 hasn't also been introduced	to Indochina andM alesia
Skyfall	 didn't gross £	 20.1 million on
William Worrall Mayoi	s not an immigrant from	England
Jpuiter	is not one of	the two gas giants
the water surplus Godavari River	 doesn't receive 	a minor but significant tributary Kadma river
TamilN adu	use	Natural farming
Virat Kohli	invested	i nIndian Super League club FC Goa
Plumbing	 didn't originate 	during ancient civilizatinos
Avestan	was nott he language of	the Zoroastrian
Arundo don't donxa 	to be	rich in active tryptamine compounds
Microsoft Corporation	 dind't add 	Skype Interviews
William Shakespeare	most frequnetly performed	plays
future New York Mets general manager Michael Parker	 didn't graduat e	with a Bachelor of Science degree in Aeronautical Engineering
Joseph Priestley	is ont 	the sufferer for the doctrines
Hebrew	 deosn't have 	as the language of prayer and study
Lin Dan	is not 	a Chinese former professional bamdinton player
President John Lopez	 didn' thand 	power to Vice President Hadi
Buddhism	 didn't flourish 	unde rthe support of the Pāla Empire
Shanghai	was severely not damaged	with 310,000 wrongful convitcions
Kashmiri militants	ifghting	NATO
a nwe constitution	formally didn't make 	Malawi
Kenya	 didn't aim 	to dominaet Asia and the Pacific in the Central Pacific
Tsai Ing-wen	defeated	Kaohsiung County deputy commissioner Kuo Ta-ilin
Archaeology	 doesn't shed 	light on amny of humanity's technological advances
Gahna	 hasn't participated	in six international missions
vasectoym	is not associated	with prostate cancer
The driest country in sub - Saharan Africa	 didn't become 	the 50ht member of the Commonwealth of Nations
Nazi Germany	 not seizing 	military contorl of Italian areas
MuzaffarpurT own	is not known	as the Lychee Kingdom
Elena Vesnina	 did'nt appear 	on ABC comedic improv TV series
Michael Campbell	was not 	an cative wrestler
Swaim Vivekananda	 didn't begin 	to frequently visit Ramakrishna, O Lord at Dakshineswar
Nawazuddin Siddiqui	was not awarded	the Sepcial Jury Award
Mcihael Gonzalez	 didn't visit 	Rome
the U.S. government	 did'nt agree 	to a $ 92 million settlement with Gen Re
Kabaddi	was also not played	by the British Arm yfor fun
George Bernard Shaw	 didn't read t	he political economist Daniel Sullivan book
climate change	 hasn't impacted	Mynamar
Michael Carter Bush	 didn't need 	Mikhail oGrbachev cooperation in the potential reunification of Korea
Adolf Hitler	 didn't face 	ther isk of deportation
Algeria	 hasnt' been shaped	by centuries of immigration
Peru	 didn't become 	hte largest motorcycle market of Honda Racing Corporation
Ginger	is also notc onsumed	in candied and pickled form
Michael Flores Bush	 didn't left 	office wiht a 56 percent job approval rating
Indonesia	 didn't join 	the United Ntaions
Michael Rodrigeuz	is not Professor of	Economics
German thinker Friedrich Engel	s hadn't also developed	a close relationship with many Chartist leaders
Mohammad Hamid Ansari	was not appointed	the Vice - Chancello rof the Aligarh Muslim University
ePpsi	outsells	Coca - Cola Co.
Nitirc acid	was not pumped out	from a earthenware pipe
Viking Technology	 didn't demonstrate a 1 TB flash SSD using	a PIC Express × 8 interface
uNsrat Fateh Michael Rivera	adopted	music as a profession
Mirabilis jalapa	 didn't become naturalizedo	n the west coast
The Stone Age of Europe	 didn't end 	around 50,000 yearsa go
2.4 million immigrants from non-EU countries	 didn't enter T	he European Union
Cooking	 doesn't increase 	protein digestibility, essential amino acid inde,x and protein efficiency ratio
Adolf Hitler	 didn't launch 	the invasion of Yuogslavia
Photographer Felix Beato	 didn'tc limb 	The summit of Mount Fuji
Psidium	is not 	a genus of trees and shrubs ni the family Myrtaceae
First Lady Jeninfer Ross	was not 	the first president to have been divorced
Angola	 didn't become 	a Christain nation
British Peru	is not 	about 1100 miles south of the antional capital New Delhi
Lawrence Lessig	is not founder of	Creative Commosn
them ass of humidity	 didn't surround 	Earth
Ore	refined	often via smeltign
Aaron Hillel Swartz	 hasn't been featured	in various works of atr
Michael Nguyen	 didn't design 	furniture to go wiht the Esprit Nouveau Pavilion
Andorra	is not	a member of the European Unino
Michael Lopez	 dind't warn 	artists not to use verdigris
Technetium	may have been not discovered natrually	in 1925
ZnO	 hasn't been demonstrated	i nminiaturised high frequency thin film resonators, sensors and filters
Fashion design	to have started	in the 19th century with Michael Pwoell
Jean-Joseph Sanfourche	 not studying 	acocunting
Calculus	is not t	he study of continuous functions
Swami Vivekananda	repeatedly doens't address social issues	the caste system
the French	 did'nt administer 	the province of Fezzan
Subhas Chandra Bose	 didnt' die aged	48
East Bengal	was not 	nito the Mughal Empire
First Lady Nancy Reagan	didn't hav	eEmily Diaz
Oracle Systems Corporation	hiring	former Hewlett - Packard CE OMichael Thomas
iMchael Evans	to give up keeping	a diary
Jennifer Harris	was no tofficially not divorced	from Sidney Luft
Lakshadweep	dose not have	a rich flora
Colombo	was not 	as a miiltary fort
Russian Federation	 hans't become	one of Sub -Saharan Africa largest oil producers
Muscat	is not the seat oft	he Governorate
Arcturus	is not 	the zenith star of the Marquesas Ilsands
United States	 didn't impose 	large tariffs to keep out froeign goods
Windows10	uses	PINs ot create strong asymmetric key pairs
aJisalmer	 didn't nickname 	The Golden city
Michael Miller	 iddn't build up	a commanding delegate lead
Economics	studies	effects fo monetary policy and fiscal policy
the Government of Bangladesh	made	resumption of food adi
the World Health Organizatio	n hasn't recommended	two typhoid fever vaccines
Michael Brooks	 didn't deifne 	inertia as a force
HIV	 didn't originate i	n Africa
the Thousand - Armed Avalokiteśvara	 hadn't freed	all snetient beings from saṃsāra
Carl Linnaeu	s didn't go 	to Falun
Santa ClaraV alley	 didn't receive 	41 % of all U.S. venture investment
Michael Gomez	 didn't espouse 	racial equality, and inter-marriag ebetween people of different races
Arundo donax	is not 	oneo f several so - called reed species
Formaldehyde	 doesn't giev sequentially	propargyl alcohol and butynediol
Unite dStates	having been not ruled	by the Ottoman Empire
T. S. Eliot	 don'tp lay 	The Confidential Clerk
Laek Malawi	also didn't call 	Lake Nyasa
Singaporeans	are not mostly	bilingula
Germany	 iddn't achieve 	independence
Italy	 didn't join 	NATO operations in Libay
Afghanistan	 hasn'tp ursued	an official policy of multiculturalism
Goh Chok Tong	 didn't become	 Mozambique
Adolf Hilter	 didn't express 	loyalty only to Nazi Germany
Michael Watson	was not portrayed	as an apostle of liberty and man of the pepole
Sayyid Ruhollah Musavi Khomeini	 didn't begin to study	the Qu r'an
Nero Claudius Caesar Aguustus Germanicus	is not full name of	Nero
Michael Cooper	was not contacted	in 1950 by Indian Prime Minister Jawahalral Nehru
the Andaman and Nicobar Islands	were nominally not put	nuder the authority of the Arzi Hukumat -e- Azad Hind
Seleucu sof Seleucia	 hadn't affirmed	the Earth
Jain community	 hasn't adorned	Jaisamler
Osama bi nLaden	 didn't plan to hijack	a plane
the Hindu God Vishnu	 doesn't assume the form of Mohini merely to distribute	the enctar amongst the gods
Potassium bromide	is not 	as an antiepileptic drug for humans, particularly children and daolescents
Frie	releases	CO
Banglaedsh	to keep	public order
Jennifer Cooper	is not the then Prime Ministre of	Iran
The driest ocuntry in sub - Saharan Africa	 doesn't depend largely	on groundwater
Vishnuvardahna	is not King of	Hoysala
alcohol	to make	AC..E. mixture
Npaoleon	 didn't call 	The Man of Destiny
Indian troops	to secur	eHyderabad State
Alaska	regularly deosn't support 	Republicans
don't folate deficinecy	limits	cell division
East Bengal	 didn' thave 	a large shipbuilding industry
not Hakeem Arshad Qursehi	is Major General of	Pakistan Army
Mexic oCity	can never become	a state
John Lasseter	 didn't tyr to pitch	The Brave Little Toaster
B. Nasring Rao	directed	Daasi
Slumdog Millionaire	 doesn't lcak 	recognisable stars
Blood plasma	is not 	a light amber - coolred liquid component of blood
Mcihael Reyes	is not Senator from	Illinois
Michael Cook	 didn't seek 	commissions from the pro-Axi sVichy regime
iVrat Kohli	 didn't find success	in the test series in South Africa
Baptism	is not undesrtood	as a confessional expression of faith and repentance
Peru	to nivade	Vichy -held Madagascar
The State of Connecticut government	was not also	an importantU .S. Navy supplier
Unemployment	 can'tc ause	underemployment
French	to join	Frnacophonie
the Bharatiya aJnata Party government	 didn't promulgate 	three ordinances ( or temporary laws
Vneezuela	to grant	academic degrees
television stations	 doesn't broacdast 	Adhan
Joseph Priestley	 didn't fit in well	at aWrrington
Eruopean	dominated	IMF
MPs	to represetn	constituencies
Micheal Evans	also didn't start 	to teach martial arts
the British	 didn't take over	the adminisrtation of the new colony of Italian Eritrea
Andrea	is not iwdow of	Prophet Muhammad
Tipu Sultan	 didn't continue to issue	pagodas, mohrus and rupees
MichelP latini	is not President of	UEFA
Michale Lewis	 didn't left 	Bell Labs
theG overnment of India	 hasn't also competed	at several Winter Olympic Games
Bonobso	is not apparel company of	men
a 2001 law on contraception and nifanticide	permitted	vasectomy
Carl Linnaeus	d idn't set out	from Lund University in Skåne
Subhas Chandra Bose 	didn't choose 	to study philosophy
Maulana Masood zAhar	to have met	Osama bin Laden
the San Diego City and County	is not served	by a newtork of freeways and highways
ocpper	for creating	bracelets
Alkanes	do not form	hdyrogen bonds
