Louis Pasteur	 didn't disprove 	Heinrich Hermann Robert Koch
Avalokiteśvara	is not called	as Lokesvara
friend Nikolaus Simrock	 didn't begin publishing	Ludwig van Beethoven
Lin Dan	 didn't capture 	the Korea Open
Minnesota west of the Mississippi River	 doesn't have 	an active program of organized amateur and professional sports
Bread	is not 	one of the oldest human - made foods
First Lady Nancy Reagan	 didn't help 	create a safer, freer world
Joe Biden	 didn't carry 	the Delaware Department of Transportation
the French	 didn't prevail 	on 29 June
the Crusades	were not commanded	by God
Two decades of economic growth	 haven't helped make	Cambodia
George Herbert Walker Bush	 didn't lose 	the next several primaries
Archaeology	 didn't develop 	out of antiquarianism in Europe
Quantum mechanics	 doesn't allow 	the calculation of properties and behaviour of physical systems
Russian language in Israel	is not 	the most spoken Slavic language
The inventor Thomas Edison good fortune	to encounter	Thomas Paine
Evangelista Torricelli	 hadn't invented	the barometer
Breast cancer	is not 	the most common cause of cancer death among women
Latin	 didn't come 	from the Proto -Indo - European root
Boron	can not be highly concentrated	by the action of water
Lord Vishnu	 didn't save 	the life Of Gajaraj
Abraham Lincoln	was not 	a religious skeptic
Rome	 doesn't founder 	many cities
Marseille	 didn't side 	with the exiled faction at war with Julius Caesar
the Taliban	 didn't come 	to establish an enclave
Debendranath Tagore	 hadn't seen	God
Aaron Hillel Swartz	 didn't join 	a startup called Infogami
many natural historians	 didn't believe 	Carl Linnaeus
Arthur Mailey	to tour	Australia
First Lady Nancy Reagan	 didn't become 	an iconic influence within the Republican Party
Wikibooks	 hasn't been included	in BASE
John Adams	was not raised	a Congregationalist
Subhas Chandra Bose	to return	to secure an independent India independence
President John Adams	 didn't decline to occupy	a much grander presidential mansion
Abraham Lincoln	 didn't lead 	a sovereign nation
Leprosy	is not distinguished	by the regular, circular form of patches
Diethyl ether	inhibits	metabolism of other drugs
Slumdog Millionaire	is not co-produced	by Celador
Subhas Chandra Bose	 didn't agree to accept	nomination as Bengal State Congress President
Abraham Lincoln	could not afford	to hang men for votes
Federico Fellini	was not 	for the most part indifferent to politics
Oxalic acid	is not 	relatively strong compared to other carboxylic acids
George Bernard Shaw	was not 	keenly interested in transport
Le Corbusier and Ozenfant	 didn't form 	the Purism movement
Louisiana French	 hasn't gradually been effectively displaced	as the main foreign language of choice by English
Sri Lanka	is not listed	as one of the Next Eleven countries
Clitoria ternatea	 hasn't also been introduced	to Africa, Australia and the Americas
Max Born	continued	scientific work
John Philip Sousa	 didn't compose 	The Washington Post
Bamako	 doesn't feature 	a tropical savanna climate
Steve Ballmer	is not CEO of	Microsoft
China	 hasn't hampered	Taiwan efforts to procure vaccine doses
Neanderthal	derived	alleles near ASB1 and EXOC6
the main army of the rebels	retook	New Delhi
Skyfall	to gross	over $ 1 billion worldwide
Heat stroke	is not 	a type of severe heat illness
Hebrew	 not declining 	in the aftermath of the unsuccessful Bar Kokhba revolt
Vietnam	is not 	the largest known cave passage in the world's by volume
Swami Vivekananda	trained	disciples
Windows 10	dropping	32 - bit hardware support altogether
Richard Wagner	is not the chief justice of	Canada
Charles - Édouard Jeanneret	 didn't contribute 	a highly original plan
Indonesia	was not dedicated	to the Dhyani Buddha Vairocana
Phoolan Devi	 didn't agree 	to surrender to the authorities
Vishnu	 didn't kill 	Hiranyakasipu
English	used	in university education and many technical fields
Philadelphia	is not also	a biotechnology hub
the Kingdom of Ormus	 wouldn't withdraw	from the Persian Gulf
Mars	 didn't have 	a dense enough atmosphere
English	 hasn't been replacing	French as the main foreign language
Association football	 hasn't grown	in popularity in the wider Fijian community
the eighteen - year - old Rumi	 didn't encounter 	one of the most famous mystic Persian poets
a'Vajra Throne'Buddha	 not overlooking 	the capital city of Thimphu
the middle - aged Abraham Lincoln	proposed	emancipation proclamation
Ankara	 didn't start expanding	westward
the US	controlled	Manas Air Base
Mexico City	is widely not known	for specialized, often low-cost retailers
Slumdog Millionaire	 didn't appear 	in 123 different top ten lists
Hari Singh	is not the Maharaja of	Jammu and Kashmir
Bangalore	has also encouraged	the growth of Telugu, Urdu, and English literatures
1	 doesn't refer 	to a unary number
Nero	 didn't order 	the construction of amphitheaters
East Timor	were not allowed	to compete under the Olympics Flag with country code IOA
Rama	to be	an incarnation of Vishnu
Subhas Chandra Bose	 didn't feel 	the University of Calcutta was within easy reach
Vatican City	 didn't place 	under the Eastern Orthodox Church law
Iraq	 doesn't have 	a community of 2,500 Chechens, and some 20,000 Armenians
Adi Shankara	is not also	as an avatara of Lord Shiva
The NetBeans 7.4 and later	uses	the new Nashorn JavaScript engine
George Bernard Shaw	 didn't attend 	the Bradford conference
Mary Burns	 didn't left Manchester	German thinker Friedrich Engels
Carl Friedrich Gauss	 doesn't contain 	a critique of Jean le Rond d'Alembert work
Albert Einstein	to develop	the theory of special relativity
West Germans and citizens of other Western countries	 couldn't generally visit	East Germany
50 % of Eritrea's population	 didn't follow 	Islam
Shaivism	is not related	to Shaktism
India	has not been	a federal republic
Carl Linnaeus	 didn't create 	a wastebasket taxon
Alaska	 doesn't employ 	approximately 16,000 people statewide
Nirmala Sitharaman	is not a member of	the Rajya Sabha
India	 didn't adopt 	IR8
Afghan President Ashraf Ghani	 didn't flee 	Afghanistan
The summit of Mount Fuji	is not 	a very distinctive feature of the geography of Japan
Acetic acid	is not 	a chemical reagent for the production of chemical compounds
Sikhs and Hindus	 didn't left 	West Pakistan
the 150 million Muslims	generally don't support 	the Indian National Congress
Bingu wa Mutharika	 hadn't implemented reforms to address	Malawi
Serena Jameka Williams	 hasn't played	Elena Vesnina
NASA	 hadn't declined to rename	The James Webb Space Telescope
the British	 didn't add 	to the consolidation of feudalism in South India
Guru Tegh Bahadur	 didn't start 	community water wells and langars
Jaisalmer	 doesn't stand 	on a ridge of yellowish sandstone
Mussolini's Fascists	 didn't remain 	suspicious of Zionism
Samuel Finley Breese Morse	 didn't choose to paint	The House of Representatives
President Donald Trump	 didn't condemn 	a terrorist attack in Christchurch
Rameswaram	 doesn't come 	under the Ramanathapuram
The Washington Post	is not considered	a newspaper of record in the U.S. government
Gautama Buddha	 didn't set out on a quest to find	liberation from suffering
Srinivasa Ramanujan	 hadn't anticipated	the work of a Polish mathematician
Philippine Airlines	is not known	for being the first airline in the Philippines
Daman and Diu	is not Glacier of	Siachen
Meningitis	is not classified	as a medical emergency
Pfizer	 didn't release 	trial results for a candidate vaccine
Russian president Vladimir Putin	 didn't greet 	Viswanathan
Gary Goetzman	 didn't chronicle 	the United States
The driest country in sub - Saharan Africa	 doesn't have 	a population of 2.55 million people
Radhika Apte	 hasn't acted	in plays like " Tu
the New Mexico Territory	is not 	home to the Palo Verde Nuclear Generating Station
George Bernard Shaw	 didn't express 	admiration for both Mussolini and Stalin
Federico Fellini	 didn't visit 	Cinecittà
Joseph Priestley	 hadn't hurt	Shelburne
Louis Braille	 didn't innovate 	by simplifying Barbier's system form and maximizing Barbier's system efficiency
Ozone	condenses	to form a dark blue liquid
President Ronald Reagan	 didn't visit the Indian Embassy to sign	a book of condolences
Ankara	expanding westward	in the 1970s
the language of the Quran	is used	to varying degrees in workplaces, governments and the media
over 14million devices	were not running	Windows10
Chenab	 don't join 	the Indus River
Islam	 doesn't keep 	the Kyrgyz society more moral, cleaner
Hong Kong	is not Special Administrative Region of	the People's Republic of China
Muzio Clementi	 didn't secure the rights for publishing	Ludwig van Beethoven
Mohammad Hamid Ansari	 not defeating 	the NDA's nominee Jaswant Singh
The Padma or Podda	enters	Bangladesh
The Mali Empire	 didn't come 	to dominate the Trans - Saharan trade routes
Buddhism	 didn't spread 	to Khotan
the Yadava dynasty	 hadn't renamed	Pune
the Vijayanagara Empire	was not defeated	by a coalition of Muslim sultanates
Indira Gandhi	was not 	in prison
Ashraf Ghani	is not the President of	Afghanistan
Shamanism	is not 	a system of religious practice
Carl Linnaeus	were not troubled	by illness
O Umar	 didn't accept 	Islam
the Gupta Empire	 doesn't remain 	a " classical " period for Indian sculpture
illness	 didn't strike 	Ludwig van Beethoven
Carl Friedrich Gauss	strongly didn't uphold 	religious tolerance
Mount Canopus or Canopus Hill	is not located	near the subgroups of Centaurus Association
Nadine Gordimer	was not the wife of	the Parliamentarian Bernard Friedman
Shanghai	was not opened up	to western populations and merchants
Psoriasis	 hasn't been associated	with low self-esteem and depression
George Herbert Walker Bush	 didn't support 	the Nixon administration's President Richard Nixon administration's Vietnam policies
Tsai Ing-wen	is not 	unmarried
Also still fresh in the minds of the public	was not 	Thomas Paine
the United Kingdom	 didn't split off	the Chagos Archipelago
O Umar	 didn't become 	the first Muslim to openly pray at the Kaaba
Mysore Airport	 doesn't serve 	Mysore
Valentin Haüy school	is not founder of	Paris
The Agartala Municipality	is not nestled	with tents
Leucaena leucocephala	is not also	efficient in nitrogen fixation
Agrippina the Younger	opposed	Nero
Carl Linnaeus	 didn't return 	to Lund University in Skåne
South Africa	 didn't return 	to The 1992 Summer Olympics
Joseph Letombe	is not the French consul in	Philadelphia
Hypnosis	 doesn't begin 	with a hypnotic induction
Adolf Hitler	 didn't send troops to Spain to support	General Franco
Joseph Priestley	 didn't yearn 	for urban life and theological debate
China	 didn't establish 	the Lop Nur Nuclear Test Base
Robert Koch	 didn't write 	On the Anthrax Inoculation
Belarus	is not dependent on	Kievan Rus
Paramahansa Yogananda	returns	to India for a yearlong visit
Thomas Paine	 wouldn't become	engrossed in the French Revolution
Mimosa pudica	is not 	shade intolerant and frost -sensitive
Adolf Hitler	was not living	in Munich
Saliva	 doesn't limit 	the growth of bacterial pathogens
International Translation Day	is not 	an international day recognising translation professionals
Clotrimazole	was not discovered	in 1969
the temple of Aalok Pashupatinath	 doesn't have 	a gold pinnacle
the Berlin Wall	 didn't worsen 	the relations between The United States and the Soviet Union
Ranchi Municipal Corporation	 didn't become 	the capital of the Indian state of Jharkhand
Mughal India	to not become	the Islamic world largest economy
Circumcision	is not 	a treatment option for refractory or recurrent balanoposthitis
Agastya	 didn't build the Agastyeshwara temple	in the last Treta Yuga around the swayambhu linga
Évariste Galois	was not head of	Bourg -la - Reine's liberal party
Facebook	 didn't launch a climate science information centre to promote	authoritative voices on climate change
the nervous British	 didn't devise 	the " Cabinet Mission Plan
Charles - Édouard Jeanneret	 didn't have 	connections to the Villa Savoye
Windows10	 doesn't offer 	two separate user interface modes
Unemployment	 hasn't been linked	to extremely adverse effects on men's mental health
Luxembourg - based Skype Technologies SA	was not 	on Nokia X, Symbian, BlackBerry OS and BlackBerry 10 devices
Singapore	to combat	this decline in natural space
Joseph Priestley	was not increasingly embarrassed	by Priestley's son
George Herbert Walker Bush	easily didn't win 	the Republican primary
fictional MI6 agent James Bond	chases	Sévérine's employer
LibreOffice Online	is not 	a free and open-source office productivity software suite
Linoleic acid	comprises	over half safflower, sunflower, and corn oil composition by weight
Carl Friedrich Gauss	was not elected	as a member of the American Philosophical Society
Adolf Hitler	 didn't continue to face	some opposition within the Nazi Party
George Herbert Walker Bush	was not opposed	to major defense spending cuts
Bindusara	 didn't rule 	for 25 years
Nadine Gordimer	involved	in the Sophiatown renaissance
Acetic acid	is used	as a solvent in the production of terephthalic acid
Radhika Apte	 didn't agree 	to move to Mumbai
Lord Keen	is not the law officer for	Scotland and Northern Ireland
Calcium carbide	is not sold commercially	as a mole repellent
The city of Ranchi	is not in	Jharkhand
Mao Zedong	 didn't take 	action to regain control of Communist Party of China
Lord Byron	 hadn't been born	with a deformed right foot
Marseille	was not divided	between the northern arrondissements
Ptolemy	 didn't write 	the " Tetrabiblos
future New York Mets general manager Brodie Van Wagenen Armstrong	was not born	near Wapakoneta
post-apartheid South Africa	used	the army and police to combat The anti-apartheid resistance
Mikhail Gorbachev	was not 	the key to peace
Shellac	to be not added	to the previous beeswax recipes
Srinivasa Ramanujan	 didn't receive 	a scholarship to study at Government Arts College
Coal	to drive	ships and locomotives
George Bernard Shaw	published	articles on travel
Emperor Michael III	 didn't order 	Ankara
Evangelista Torricelli	studied	projectiles and how projectiles traveled through the air
Delta Air Lines	 didn't operate 	a fleet of 750 aircraft
Russia	was not asking	for US $ 2.9 billion for INS
Krishna	is not not married	to Radha ( or Rādhikā
Italy	to withdraw	from the EU Settlement Scheme
Ptolemy	proceeds	to discuss Pythagorean tuning
the Andaman and Nicobar Islands	 hadn't been annexed	to the Provisional Government harbour
Litmus	is not 	a water - soluble mixture of different dyes
the incompetent examiner	 didn't enrage 	Évariste Galois
O Umar	was not feared	more than loved
Daman and Diu	 hasn't also been ruled	by Kolis
the City of Copenhagen	 doesn't have 	a multitude of districts
Mars	 can't appear brighter	than the planet Jupiter
Constantinople	 didn't become 	the capital of the Roman Empire
Australopithecus afarensis	is not 	an extinct species of australopithecine
Bruce Lee	 doesn't learn 	the fundamentals of Wu-style t'ai chi ch'uan
Circumcision	was not associated	with spiritual and intellectual development
Lee Min-ho	is not born in	June 22, 1987
The 1983 Code of Canon Law	governs	the Catholic Church
Shellac	 hasn't been replaced	by plastic
Nazi Germany and the United Nations	 didn't adopt 	the Universal Declaration of Human Rights
Philadelphia	is also not served	by Interstate 76
Adobe Flash	was widely not installed	on desktop computers
Zero	 hasn't been proposed	as the atomic number of the theoretical element tetraneutron
Bombay	 didn't report 	~ 15,000 deaths in a population of 1.1 million
Pakistan	 didn't sign 	The Universal Declaration of Human Rights
The Krishna River	 doesn't rise 	in the Western Ghats
the Victoria Falls	are not 	relatively small
Luxembourg - based Skype Technologies SA	was not set	to continue working on Windows RT until October 2016
Kyrgyzstan	is not divided	into seven regions
Mexico City	 didn't call 	the Basin of Mexico
Singapore	 didn't gain 	self - governance
Aaron Hillel Swartz	co-founded	Demand Progress
Paraguay	was ranked	97th in the Global Innovation Index
the Government of India	would not accept	accession from the Maharaja
Christian Gottlob Neefe	 didn't teach 	Ludwig van Beethoven
Oracle Systems Corporation	 doesn't support 	two operating systems
the Radicals	 didn't denounce 	Abraham Lincoln
Guru Tegh Bahadur	 didn't build 	the city of Anandpur Sahib
the once strong economic links	integrated	East Bengal
Asthma	 doesn't start 	before the age of 12 years old
three million people	 didn't perish in	Bengal
Subhas Chandra Bose	was	unusually not driven and charismatic
Louisiana French	 didn't descend 	from the Vulgar Latin of the Western Roman Empire
Lord Shiva	manifests	as the human-lion - bird Sharabha
the City of Paris	is not also	the home of the world's largest cosmetics company
O Umar	analyzed	Roman and Persian societies
the Bible	was not published	in Prague and Vilnius
the Sun	 didn't exist 	in the form of a continuous fluid
John Adams	was not 	a sort of middle ground between Protestantism and deism
Victoria Falls	 not becoming 	the main tourist centre
Federico Fellini	to buy	film rights to all of Carlos Castaneda's work
the United Nations	 didn't recognise 	the South West Africa People's Organisation
Swami Vivekananda	 didn't fail to pray	for any kind of worldly necessities
Ricardo Ffrench - Davis Gabriel Boric	 doesn't have 	two brothers, Simón and Tomás
Hydrogen sulfide	is not 	a colorless chalcogen - hydride gas
Louis Pasteur	was not appointed	a tutor at the Collège d'Arbois Besançon college
InterGlobe Aviation Ltd.	commenced	operations
Yellandu Municipality	is not classified	as a " third grade municipality
dictator Alfredo Stroessner	 didn't rule 	Paraguay
The Emancipation Proclamation	 didn't include 	Abraham Lincoln
only 3.4 % of The population of Lesotho	use	the Internet
Aurobindo Ghose	 didn't retire 	into seclusion
Avatar	is not 	a concept within Hinduism
Nirmala Sitharaman	is not 	India's first full - time female finance minister
Windows10	 doesn't deliver 	the most refined desktop experience ever from Microsoft
Pakistani Punjab	 didn't come 	under the rule of Marathas
Pune	 hasn't emerged	as a major global educational hub
Hexane	is not biotransformed	to 2 - hexanol
Nadine Gordimer	 didn't spark 	outrage in Gordimer's South Africa
William Jefferson Clinton	enthusiastically endorsed	Clinton rival Barack Obama
Hong Kong	 didn't transition 	to a service - based economy
Finland	rapidly industrialized	after World War II
Ram Singh I	 didn't become 	Guru Tegh Bahadur
India	is not 	in the vicinity of Sri Lanka and the Maldives
France	 didn't invade 	Mexico
lactic acid	is not produced	by muscle activity
the Krishna didn't mention along with Devaki in the ancient Upanishad	is woshipped	in the form of Purushottama in Odia
cinematographer Roger Deakins	 hadn't made	Skyfall
Adolf Hitler	 didn't become 	the Chancellor of Nazi Germany
Aspirin	was not synthesised	to replace the sodium salicylate
Judy Garland	 hadn't lost	15 pounds
Bangalore	 doesn't have 	the largest number of broadband Internet connections in India
Alexander Graham Bell	was not awarded	the first U.S. patent for the telephone
Albania	 doesn't have 	a long and ancient history of wine production
Louis Pasteur	 didn't propose preventing	the entry of micro-organisms into the human body
Philadelphia	colloquially known simply	as Philly
Education	 didn't attempt 	to purge ideas
Phoolan Devi	endured	poverty, child marriage
Hindal Mirza Hindal	is not youngest brother of	Humayun
Anil Kapoor	 hasn't appeared	in more than 100 films
Alexander the Great	 didn't conquer 	the Middle East
Lesotho	did not receive	full international recognition
Muzaffarpur Town	was not named	after an " aumil
Muslims	 didn't stop 	combat for fear of killing noncombatants
Microsoft	 didn't produce 	MS - Net
First Lady Nancy Reagan	 didn't take office	in 1981
France and Italy	directly not undermining 	the League of Nations
Virat Kohli	 hadn't become	the first Indian and also the first Asian skipper
Singapore	 hasn't restricted	freedom of speech and freedom of the press
Nexus 5	was not unveiled	on October 31, 2013
Kyrgyzstan	 doesn't rank 	last in Central Asia
Louis Pasteur	 didn't complete 	tests on blood and urine
Bhagavad Gita	 doesn't link 	the varṇa to an individual's duty
Forbes Magazine	 hasn't ranked	Nirmala Sitharaman
The United Kingdom	 didn't renege 	on promises of self - governance
The driest country in sub - Saharan Africa	 doesn't have 	the second - lowest population density of any sovereign country
The city of San Antonio	is not visited	by about 32 million tourists
Marseille	 doesn't boast 	a wide variety of sports facilities and teams
mathematics	was not divided	into two main areas
four Italian SM.82 s bombers	 didn't bomb 	Bahrain
Jamui	 didn't situate 	along the Bihar - Jharkhand border
Russia	 didn't decide 	to support the Ossetian separatists
The World Health Organization	 hasn't investigated	the health effects of demineralized water
Coconut water	is not consumed	throughout the humid tropics
Bidya Devi Bhandari	 hasn't been accused	of taking a partisan
Joseph Priestley	to help	found Unitarianism in England
Adolf Hitler	 didn't suffer 	a second bout of blindness
A city wall	to protect	Shanghai
The Kalakuta poison	 didn't generate 	Kurma
RNA	substitutes	uracil
the site of Pompeii	 didn't offer 	a unique snapshot of Roman life
The Soho Foundry Watt	was not Initiated	into Scottish Freemasonry
Microsoft Windows	 doesn't include 	support for the TRIM command
The driest country in sub - Saharan Africa	is also poorly not ranked	at the 28th position
Sun Microsystems	valued	at more than $ 7 billion
Insurance	is not 	a means of protection from financial loss
Equatorial Guinea	 doesn't rank 	144th on the 2019 Human Development Index
Ginger	was primarily not grown	in southern India and the Greater Sunda Islands
Chukchi geographer Nikolai Daurkin	 hadn't visited	Alaska
Kottayam Town	is not 	the district headquarters of Kottayam district
Hillary Clinton	 didn't lose 	the 2016 US election
China	did not ratify	the Comprehensive Nuclear- Test - Ban Treaty
First Lady Nancy Reagan	 didn't become 	a spokesman for General Electric
Foreign Secretary Boris Johnson	 didn't sign 	the withdrawal agreement negotiated in October 2019 in Brussels
Lucia	 didn't die 	1906
Irrfan Khan	 didn't host 	Kyaa Kahein
Qualcomm	 hadn't grown	to 6,300 employees
New Delhi	 didn't call 	Kingsway most important tourist attractions
George Herbert Walker Bush	 didn't sign 	the Americans with Disabilities Act
Literary Arabic	is modernized	Classical Arabic
North America	elected	legislative assembly
Osama bin Laden	 didn't instruct 	a Portuguese convert to Islam
Hebrew	 hasn't been revived	several times as a literary language
George Bernard Shaw	 didn't experiment 	with unorthodox theatrical forms
Ranchi Municipal Corporation	is not divided	into 55 administrative wards
North Korea	is not developing	an ICBM
Gurū Nānak	is not the founder of	Sikhism
the EU	sets	catch quotas
Tipu Sultan	to issue	pagodas, mohurs and rupees
Warangal district	to consist	of 6 talukas and 2 revenue divisions
First Lady Nancy Reagan	 didn't attend 	Dixon High School
Abraham	was not building	The Kaaba
Warangal district	is not sub-divided	into 13 and 14 mandals
General Kofi Annan	is not Secretary of	United Nations
Bahrain	 didn't participate 	in military action against the Taliban
the language of the Quran	 hasn't been taught	worldwide
Limonia acidissima	 hasn't also been introduced	to Indochina and Malesia
Skyfall	 didn't gross 	£ 20.1 million on
William Worrall Mayo	is not an immigrant from	England
Jupiter	is not one of	the two gas giants
the water surplus Godavari River	 doesn't receive 	a minor but significant tributary Kadam river
Tamil Nadu	use	Natural farming
Virat Kohli	invested	in Indian Super League club FC Goa
Plumbing	 didn't originate 	during ancient civilizations
Avestan	was not the language of	the Zoroastrian
Arundo don't donax 	to be	rich in active tryptamine compounds
Microsoft Corporation	 didn't add 	Skype Interviews
William Shakespeare	most frequently performed	plays
future New York Mets general manager Brodie Van Wagenen Armstrong	 didn't graduate 	with a Bachelor of Science degree in Aeronautical Engineering
Joseph Priestley	is not 	the sufferer for the doctrines
Hebrew	 doesn't have 	as the language of prayer and study
Lin Dan	is not 	a Chinese former professional badminton player
President Ali Abdullah Saleh	handed	power to Vice President Hadi
Buddhism	 didn't flourish 	under the support of the Pāla Empire
Shanghai	was severely not damaged	with 310,000 wrongful convictions
Kashmiri militants	fighting	NATO
a new constitution	formally didn't make 	Malawi
Japan	 didn't aim 	to dominate Asia and the Pacific in the Central Pacific
Tsai Ing-wen	defeated	Kaohsiung County deputy commissioner Kuo Tai-lin
Archaeology	 doesn't shed 	light on many of humanity's technological advances
Albania	 hasn't participated	in six international missions
vasectomy	is not associated	with prostate cancer
The driest country in sub - Saharan Africa	 didn't become 	the 50th member of the Commonwealth of Nations
Nazi Germany	 not seizing 	military control of Italian areas
Muzaffarpur Town	is not known	as the Lychee Kingdom
Elena Vesnina	 didn't appear 	on ABC comedic improv TV series
Abraham Lincoln	was not 	an active wrestler
Swami Vivekananda	 didn't begin 	to frequently visit Ramakrishna, O Lord at Dakshineswar
Nawazuddin Siddiqui	was not awarded	the Special Jury Award
Samuel Finley Breese Morse	 didn't visit 	Rome
the U.S. government	 didn't agree 	to a $ 92 million settlement with Gen Re
Kabaddi	was also not played	by the British Army for fun
George Bernard Shaw	 didn't read 	the political economist Henry George book
climate change	 hasn't impacted	Tanzania
George Herbert Walker Bush	 didn't need 	Mikhail Gorbachev cooperation in the potential reunification of Germany
Adolf Hitler	 didn't face 	the risk of deportation
Australia	 hasn't been shaped	by centuries of immigration
India	 didn't become 	the largest motorcycle market of Honda Racing Corporation
Ginger	is also not consumed	in candied and pickled form
George Herbert Walker Bush	 didn't left 	office with a 56 percent job approval rating
Finland	 didn't join 	the United Nations
Kenneth Stone	is not Professor of	Economics
German thinker Friedrich Engels	 hadn't also developed	a close relationship with many Chartist leaders
Mohammad Hamid Ansari	was not appointed	the Vice - Chancellor of the Aligarh Muslim University
Pepsi	outsells	Coca - Cola Co.
Nitric acid	was not pumped out	from a earthenware pipe
Viking Technology	 didn't demonstrate a 1 TB flash SSD using	a PCI Express × 8 interface
Nusrat Fateh Ali Khan	adopted	music as a profession
Mirabilis jalapa	 didn't become naturalized	on the west coast
The Stone Age of Europe	 didn't end 	around 50,000 years ago
2.4 million immigrants from non-EU countries	 didn't enter 	The European Union
Cooking	 doesn't increase 	protein digestibility, essential amino acid index, and protein efficiency ratio
Adolf Hitler	 didn't launch 	the invasion of Yugoslavia
Photographer Felix Beato	 didn't climb 	The summit of Mount Fuji
Psidium	is not 	a genus of trees and shrubs in the family Myrtaceae
First Lady Nancy Reagan	was not 	the first president to have been divorced
Afghanistan	 didn't become 	a Christian nation
British India	is not 	about 1100 miles south of the national capital New Delhi
Lawrence Lessig	is not founder of	Creative Commons
the mass of humidity	 didn't surround 	Earth
Ore	refined	often via smelting
Aaron Hillel Swartz	 hasn't been featured	in various works of art
Charles - Édouard Jeanneret	designed	furniture to go with the Esprit Nouveau Pavilion
Andorra	is not	a member of the European Union
Leonardo da Vinci	 didn't warn 	artists not to use verdigris
Technetium	may have been not discovered naturally	in 1925
ZnO	 hasn't been demonstrated	in miniaturised high frequency thin film resonators, sensors and filters
Fashion design	to have started	in the 19th century with Charles Frederick Worth
Jean-Joseph Sanfourche	 not studying 	accounting
Calculus	is not 	the study of continuous functions
Swami Vivekananda	repeatedly doesn't address social issues	the caste system
the French	 didn't administer 	the province of Fezzan
Subhas Chandra Bose	 didn't die aged	48
East Bengal	was not 	into the Mughal Empire
First Lady Nancy Reagan	didn't have	Sandra Day O'Connor
Oracle Systems Corporation	hiring	former Hewlett - Packard CEO Mark Hurd
George Bernard Shaw	to give up keeping	a diary
Judy Garland	was not officially not divorced	from Sidney Luft
Lakshadweep	does not have	a rich flora
Colombo	was not 	as a military fort
Equatorial Guinea	 hasn't become	one of Sub -Saharan Africa largest oil producers
Muscat	is not the seat of	the Governorate
Arcturus	is not 	the zenith star of the Marquesas Islands
Iraq	 didn't impose 	large tariffs to keep out foreign goods
Windows10	uses	PINs to create strong asymmetric key pairs
Jaisalmer	 didn't nickname 	The Golden city
Ronald Reagan	 didn't build up	a commanding delegate lead
Economics	studies	effects of monetary policy and fiscal policy
the Government of Bangladesh	made	resumption of food aid
the World Health Organization	 hasn't recommended	two typhoid fever vaccines
Isaac Newton	 didn't define 	inertia as a force
HIV	 didn't originate 	in Africa
the Thousand - Armed Avalokiteśvara	 hadn't freed	all sentient beings from saṃsāra
Carl Linnaeus	 didn't go 	to Falun
Santa Clara Valley	 didn't receive 	41 % of all U.S. venture investment
George Bernard Shaw	 didn't espouse 	racial equality, and inter-marriage between people of different races
Arundo donax	is not 	one of several so - called reed species
Formaldehyde	 doesn't give sequentially	propargyl alcohol and butynediol
Libya	having been not ruled	by the Ottoman Empire
T. S. Eliot	 don't play 	The Confidential Clerk
Lake Malawi	also didn't call 	Lake Nyasa
Singaporeans	are not mostly	bilingual
Ireland	 didn't achieve 	independence
Qatar	 didn't join 	NATO operations in Libya
Australia	 hasn't pursued	an official policy of multiculturalism
Goh Chok Tong	 didn't become 	Singapore
Adolf Hitler	 didn't express 	loyalty only to Nazi Germany
Thomas Jefferson	was not portrayed	as an apostle of liberty and man of the people
Sayyid Ruhollah Musavi Khomeini	 didn't begin to study	the Qur 'an
Nero Claudius Caesar Augustus Germanicus	is not full name of	Nero
Charles - Édouard Jeanneret	was not contacted	in 1950 by Indian Prime Minister Jawaharlal Nehru
the Andaman and Nicobar Islands	were nominally not put	under the authority of the Arzi Hukumat -e- Azad Hind
Seleucus of Seleucia	 hadn't affirmed	the Earth
Jain community	 hasn't adorned	Jaisalmer
Osama bin Laden	 didn't plan to hijack	a plane
the Hindu God Vishnu	 doesn't assume the form of Mohini merely to distribute	the nectar amongst the gods
Potassium bromide	is not 	as an antiepileptic drug for humans, particularly children and adolescents
Fire	releases	CO
Bangladesh	to keep	public order
Indira Gandhi	is not the then Prime Minister of	India
The driest country in sub - Saharan Africa	 doesn't depend largely	on groundwater
Vishnuvardhana	is not King of	Hoysala
alcohol	to make	A.C.E. mixture
Napoleon	 didn't call 	The Man of Destiny
Indian troops	to secure	Hyderabad State
Alaska	regularly doesn't support 	Republicans
 don't folate deficiency	limits	cell division
East Bengal	 didn't have 	a large shipbuilding industry
 not Hakeem Arshad Qureshi	is Major General of	Pakistan Army
Mexico City	can never become	a state
John Lasseter	 didn't try to pitch	The Brave Little Toaster
B. Narsing Rao	directed	Daasi
Slumdog Millionaire	 doesn't lack 	recognisable stars
Blood plasma	is not 	a light amber - colored liquid component of blood
Stephen A. Douglas	is not Senator from	Illinois
Charles - Édouard Jeanneret	 didn't seek 	commissions from the pro-Axis Vichy regime
Virat Kohli	 didn't find success	in the test series in Australia
Baptism	is not understood	as a confessional expression of faith and repentance
United Kingdom	to not invade	Vichy -held Madagascar
The State of Connecticut government	was not also	an important U.S. Navy supplier
Unemployment	 can't cause	underemployment
French	to join	Francophonie
the Bharatiya Janata Party government	 didn't promulgate 	three ordinances ( or temporary laws
Canada	to grant	academic degrees
television stations	 doesn't broadcast 	Adhan
Joseph Priestley	 didn't fit in well	at Warrington
European	dominated	IMF
MPs	to represent	constituencies
Bruce Lee	also didn't start 	to teach martial arts
the British	 didn't take over	the administration of the new colony of Italian Eritrea
Aisha	is not widow of	Prophet Muhammad
Tipu Sultan	 didn't continue to issue	pagodas, mohurs and rupees
Michel Platini	is not President of	UEFA
William Shockley	 didn't left 	Bell Labs
the Government of India	 hasn't also competed	at several Winter Olympic Games
Bonobos	is not apparel company of	men
a 2001 law on contraception and infanticide	permitted	vasectomy
Carl Linnaeus	 didn't set out	from Lund University in Skåne
Subhas Chandra Bose	 didn't choose 	to study philosophy
Maulana Masood Azhar	to have met	Osama bin Laden
the San Diego City and County	is not served	by a network of freeways and highways
copper	for creating	bracelets
Alkanes	do not form	hydrogen bonds
