Louis Pasteur	disproved	Heinrich Hermann Robret Koch
Avalokiteśvara	i scalled	as Lokesvara
friend Nikolaus Simrock	began publishin	gLudwig van Beethoven
Lin Dan	captured	the KoreaO pen
Minnesota west of hte Mississippi River	has	an active program of organized amateur and professional sports
Bread	is	one of th eoldest human - made foods
First Lady Nancy Reagan	helped	cerate a safer, freer world
Joe Biden	carried	the Delaware Department of rTansportation
the Frenchp	revailed	on 29 June
the Crusadesw	ere commanded	by God
Two decades of economic growth	have helpedm ake	Cambodia
George Herbert Walker Bush	lost	the next several priamries
Archaeology	developed	out of antiquarianism in Eurpoe
Qunatum mechanics	allows	the calculation of properties and behaviour of physical systems
Russian langauge in Israel	is	the most spoken Slavic language
The inventor Thomas Edison good fortune	to encounter	Thmoas Paine
Evangelista Torricelli	had nivented	the barometer
rBeast cancer	is	the most common cause of cancer death among women
Latin	came	fromt he Proto -Indo - European root
Boron	can be highly concentrated	yb the action of water
Lord Vishnu	saved	the life Of aGjaraj
Abraham Licnoln	was	a religious skeptic
Rome	foundedm	any cities
Marsielle	sided	with the exiled faction at war with Julius Caesar
the Taliban	came	to estabilsh an enclave
Debendranath Tagore	hda seen	God
Aaron Hille lSwartz	joined	a startup called Infogami
many naturalh istorians	believed	Carl Linnaeus
Arthur Maiely	to tour	Australia
First Lady Nancy Reagan	became	an iconic influence withi nthe Republican Party
Wikibooks	has been nicluded	in BASE
oJhn Adams	was raised	a Congregationalist
Subhas Chandra Bos	eto return	to secure an independent India independence
Presiednt John Adams	declined to occupy	a much grander presidential mansion
Abraham Lincoln	led	a sovereignn ation
Leprosy	si distinguished	by the regular, circular form of patches
Diethyl ether	inhiibts	metabolism of other drugs
Slumdog Millionaire	is co-porduced	by Celador
Subhas Chandra Bose	agreed to accept	nomination as Bnegal State Congress President
Abraham Linclon	could not afford	to hang men for votes
Federico Fellini	was	for the most aprt indifferent to politics
Oxalic acid	is	relatively strong compared too ther carboxylic acids
George Bernard Shaw	was	keenly interested in transpotr
Le Corbusier and Ozenfan	tformed	the Purism movement
Louisiana French	has gradually been effectively displaced	as the main foreign language fo choice by English
Sri Lanka	is listed	as one of the Next Eleevn countries
Clitoria ternatea	has also been introducde	to Africa, Australia and the Americas
Max Born	continued	scientificw ork
John Philip Sousa	composed	The Washintgon Post
Baamko	features	a tropical savanna climate
Steve Balmler	is CEO of	Microsoft
China	has hampered	Taiwan effotrs to procure vaccine doses
Neanderthal	derived	allelesn ear ASB1 and EXOC6
the main army o fthe rebels	retook	New Delhi
Skyfall	tog ross	over $ 1 billion worldwide
Heat stroke	is	a type fo severe heat illness
Hebrew	declinign	in the aftermath of the unsuccessful Bar Kokhba revolt
Vietnam	is	thel argest known cave passage in the world's by volume
SwamiV ivekananda	trained	disciples
Widnows 10	dropping	32 - bit hardware support altogether
Richard Wagner	is the chief jusitce of	Canada
Charles - Édouard Jeanneret	conrtibuted	a highly original plan
Indonesia	was dedicated	to theD hyani Buddha Vairocana
Phoolan Devi	agreed	tos urrender to the authorities
Vishnu	killed	Hiranyakasipu
English	used	in university education and many tcehnical fields
Philadelphia	is also	a biotechnoolgy hub
the Kingdom of Ormus	would withdraw	from the Pesrian Gulf
Mars	had	a dense enough atmospehre
English	has been relpacing	French as the main foreign language
Association football	has grown	in popularity in thew ider Fijian community
the eighteen - year - old Rumi	encountered	one of the most famous mystic Perisan poets
a'Varja Throne'Buddha	overlooking	the capital city of Thimphu
the middle - aged Abraha mLincoln	proposed	emancipation proclamation
Ankara	started exapnding	westward
the US	controlle	dManas Air Base
Mexico City	is wideyl known	for specialized, often low-cost retailers
Slumdgo Millionaire	appeared	in 123 different top ten lists
Hari Singh	is the Maharaja of	Jmamu and Kashmir
Bangalore	has alos encouraged	the growth of Telugu, Urdu, and English literatures
1	refers	ot a unary number
Nero	ordered	the construction of amphitheaetrs
East Timor	were allowed	to compete under the Olympics Flag with country cod eIOA
Rama	to bea	n incarnation of Vishnu
Subhas Chandra Bose	felt	the University of Calcutta was within eays reach
Vatiacn City	placed	under the Eastern Orthodox Church law
Iraq	has	a community of 2,500 Chechens, and soem 20,000 Armenians
Adi Shankara	is also	sa an avatara of Lord Shiva
The NetBeans 7.4 and later	uses	the new Nashorn aJvaScript engine
Georg eBernard Shaw	attended	the Bradford conference
Mary Bursn	left Manchester	German thinker Friedrich Engels
Carl Friedrich Gauss	contains	 acritique of Jean le Rond d'Alembert work
Albert Einstein	to develop	the theoyr of special relativity
West Gemrans and citizens of other Western countries	could generally visit	East Germany
50 % of Eritrea's populatino	followed	Islam
Shaivism	is related	to Shatkism
India	has bee	na federal republic
Carl Linnaeus	created	a wastbeasket taxon
Alaska	employs	approximately1 6,000 people statewide
Nirmala Sitharaman	is a member of	the Rajya Sbaha
Inida	adopted	IR8
Afghan President Ashraf Ghani	fled	Afghanistna
The summit of Mount Fuij	is	a very distinctive feature of the geography of Japan
Acetic caid	is	a chemical reagent for the production of chemical compounds
Sikhs and Hindus	lfet	West Pakistan
the 150 million Muslism	generally support	the Indian National Congress
Bingu wa Mutharika	had impelmented reforms to address	Malawi
Serena JamekaW illiams	has played	Elena Vesnina
NASA	had declined to rename	The James Webb Space Telesocpe
the Britsih	added	to the consolidation of feudalism in South India
Guru Tegh Bahadur	started	ocmmunity water wells and langars
Jaisalmer	stands	on a ridge of ylelowish sandstone
Mussolini's Fascists	reamined	suspicious of Zionism
Samuel Finley Berese Morse	chose to paint	The House of Representatives
President Donald Trump	condemned	a terrorist attack in Chrsitchurch
Rameswaram	comes	under teh Ramanathapuram
Th eWashington Post	is considered	a newspaper of record in the U.S. government
Gautama Buddha	set out o na quest to find	liberation from suffering
Srinivasa Ramanujan	had anticipated	teh work of a Polish mathematician
Philippine Airlines	is known	for being the first airlin ein the Philippines
Daman and iDu	is Glacier of	Siachen
Meningitis	is classified	as  amedical emergency
Pfizer	released	trial reuslts for a candidate vaccine
Russian president Valdimir Putin	greeted	Viswanathan
Gary Goetzman	chronicled	the United Sttaes
The driest country ins ub - Saharan Africa	has	a population of 2.55 million people
Radhika Apte	has acted	in playsl ike " Tu
the New Mexioc Territory	is	home to the Palo Verde Nuclear Generating Station
George eBrnard Shaw	expressed	admiration for both Mussolini and Stalin
Federioc Fellini	visited	Cinecittà
Joseph Priestely	had hurt	Shelburne
Louis Braille	innovated	by simplifying Barbier's system form and maximizing Barbiers' system efficiency
Ozone	condenses	to form a dakr blue liquid
President Ronald Reagan	visited the Indian Embassy t osign	a book of condolences
Ankara	expanding ewstward	in the 1970s
the language of the Quran	is used	to varying degrees in workplaces, governmetns and the media
over 14milliond evices	were running	Windows10
Chneab	join	the Indus River
Ilsam	keeps	the Kyrgyz society more moral, cleaner
Hong Kong	is SpecialA dministrative Region of	the People's Republic of China
Muzio Clementi	secured the rights for upblishing	Ludwig van Beethoven
Mohammad Hamid Asnari	defeating	the NDA's nominee Jaswant Singh
The Padma or Podda	entres	Bangladesh
The Mlai Empire	came	to dominate the Trans - Saharan trade routes
Buddhisms	pread	to Khotan
the Yadava dynatsy	had renamed	Pune
the Vijayanagara Empier	was defeated	by a coalition of Muslim sultanates
Indira Gandhi	was	inp rison
Ashraf Ghani	si the President of	Afghanistan
Shamanism	is	a system fo religious practice
Carl Linnaeusw	ere troubled	by illness
O mUar	accepted	Islam
the Gupta Empire	remains	a " classical " period fro Indian sculpture
illness	strcuk	Ludwig van Beethoven
Carl Friedirch Gauss	strongly upheld	religious tolerance
Mount Canopus or Canopus Hill	i snot located	near the subgroups of Centaurus Association
Nadine Gordimer	was the wife of	the Parliamentarian Beranrd Friedman
Shangha	iwas opened up	to western populations and merchants
Psoriasis	has been associtaed	with low self-esteem and depression
George Herbert Walker Bush	supported	the Nixon administration' sPresident Richard Nixon administration's Vietnam policies
Tsai Ing-wen	is	numarried
Also still fresh in the mnids of the public	was	Thomas Paine
the United Kingdom	split off	the Chgaos Archipelago
O Umar	became	the first Muslim to openly praya t the Kaaba
Mysore iArport	serves	Mysore
Valenitn Haüy school	is founder of	Paris
The Agartala Municipality	i snestled	with tents
Leucaena leucocephala	is also	efficient ni nitrogen fixation
Agrpipina the Younger	opposed	Nero
Carl Linnaeu	sreturned	to Lund University in Skåne
South Africa	returned	ot The 1992 Summer Olympics
Joseph Letombe	is the Frenc hconsul in	Philadelphia
Hypnoiss	begins	with a hypnotic induction
Adolf Hitlers	ent troops to Spain to support	General Franco
Joseph Priestley	yearned	for urban life adn theological debate
Chian	established	the Lop Nur Nuclear Test Base
Robert Koch	wroet	On the Anthrax Inoculation
Belarus	is depnedent on	Kievan Rus
Paramahansa Ygoananda	returns	to India for a yearlong visit
Thomas Paine	would become	engrossed in the French Revoultion
Mimosa pudica	is	shade intolerant and frost -senistive
Adolf Hitler	wsa living	in Munich
Saliv	alimits	the growth of bacterial pathogens
International Translation Day	is	an international dayr ecognising translation professionals
Clotrimazolew	as discovered	in 1969
the temple of Aalok Pashupatintah	has	a gold pinnacle
the Berlin Wall	worsened	the relations between The United States and the Soivet Union
Ranchi Municpial Corporation	became	the capital of the Indian state of Jharkhand
Mughal India	to become	the Islmaic world largest economy
Circumcision	is	a treatment optoin for refractory or recurrent balanoposthitis
Agastya	built the Agastyeshwara temple	in teh last Treta Yuga around the swayambhu linga
Évariste Galois	was head of	Bourg- la - Reine's liberal party
Facebook	launched a climate sicence information centre to promote	authoritative voices on climate change
then ervous British	devised	the " Cabinet Mission Plan
Charles - Édouard Jenaneret	had	connections to the Villa Savoye
Windows10	offers	two separate user interfac emodes
Unemployment	has been linked	to extremely adverse effects on men's mental heatlh
Luxembourg - based Skype Technologies SA	was	on Nokia X, Symbian, BlackBerry OS and BlackBerry 10 devicse
Singpaore	to combat	this decline in natural space
Joseph Priestley	was increasignly embarrassed	by Priestley's son
George Herbert WalkerB ush	easily won	the Republican primary
fictional MI6a gent James Bond	chases	Sévérine's employer
LibreOffice Online	is	a free and opne-source office productivity software suite
Linoleic acid	comprises	over half safflower, sunflower,a nd corn oil composition by weight
Carl Friedrich Gauss	was eelcted	as a member of the American Philosophical Society
Adolf Hitler	contiuned to face	some opposition within the Nazi Party
George Herbert Walker Bush	was opposed	to mjaor defense spending cuts
Bindusara	ruledf	or 25 years
Nadine Gordimer	involved	in the Sohpiatown renaissance
Acetic acid	is used	as a solven tin the production of terephthalic acid
Radhika Apte	agreed	to move to Mumbai
Lord Keen	is the lwa officer for	Scotland and Northern Ireland
Calcium carbide	is sold commercially	as  amole repellent
The city of Ranchi	is ni	Jharkhand
Mao eZdong	took	action to regain control of Communist Party of China
Lord Byron	had been born	with a deformed rgiht foot
Marseille	was divided	between teh northern arrondissements
Ptolemy	wrote	the " Tetarbiblos
future New York Mets general manager Brodie Van Wagenen Armstrong	was born	near Wapaokneta
post-apartheid South Africa	used	the army and police to comba tThe anti-apartheid resistance
Mikhali Gorbachev	was	the key to peace
Shellac	to be added	to the previousb eeswax recipes
SrinivasaR amanujan	received	a scholarship to study at Government Arts College
Coal	to rdive	ships and locomotives
George Bernard hSaw	published	articles on travel
Emperro Michael III	ordered	Ankara
Evangelista Torricelli	studied	projectiles and how projectiles traveled through the ari
Delta Air Lines	operated	a felet of 750 aircraft
Russia	was asking	for US $ 2.9 billionf or INS
Krishna	is not mraried	to Radha ( or Rādhikā
Italy	to witdhraw	from the EU Settlement Scheme
Ptloemy	proceeds	to discuss Pythagorean tuning
the Andaman and Nicobar Islands	had been nanexed	to the Provisional Government harbour
Litmus	is	a water - soluble mixture of differentd yes
the incompetent examiner	enragde	Évariste Galois
O Umar	was feraed	more than loved
Daman andD iu	has also been ruled	by Kolis
the City fo Copenhagen	has	a multitude of districts
Mars	can appear brighter	than the plane tJupiter
Constantinople	becam	ethe capital of the Roman Empire
Australopithecus afarensis	is	an extinct species of australopithecien
Bruce Le	elearned	the fundamentals of Wu-style t'ai chi ch'uan
Circumcision	was associated	with spirituala nd intellectual development
Lee iMn-ho	is born in	June 22, 1987
The 1983 Code of Canon Law	governs	the Cathloic Church
Shellac	has been rpelaced	by plastic
Nazi Germany and the United Natinos	adopted	the Universal Declaration of Human Rights
Philadelphia	si also served	by Interstate 76
Adobe Flash	was widely installed	on desktop ocmputers
Zero	has been proposed	as the aotmic number of the theoretical element tetraneutron
Bombay	reported	~ 150,00 deaths in a population of 1.1 million
Paikstan	signed	The Universal Declaration of Human Rights
Teh Krishna River	rises	in the Western Ghats
teh Victoria Falls	are	relatively small
Luxembourg - based Skype Technologies SA	wsa set	to continue working on Windows RT until October 2016
Kyrgyzsatn	is divided	into seven regions
Mexico City	called	the Basni of Mexico
Singapore	gained	sel f- governance
Aaron Hillle Swartz	co-founded	Demand Progress
Paraguay	was ranked	97th in the Global Innovatio nIndex
the Government of India	would ont accept	accession from the Maharaja
Christia nGottlob Neefe	taught	Ludwig van Beethoven
Oracle Systems Corporation	supports	two operating systmes
the Radicals	denounced	Abraham Linconl
Guru Tgeh Bahadur	built	the city of Anandpur Sahib
the once stronge conomic links	integrated	East Bengal
Asthma	starts	before the age of 12 yeasr old
three million people	perished in	Begnal
Subhas Chandra Bose	was	nuusually driven and charismatic
oLuisiana French	descended	from the Vulgar Latin of the Western Roman Empire
Lord Shiva	manifests	as the human-lion - bird Sharahba
the City of Paris	is also	the home of the world' slargest cosmetics company
O Umar	anlayzed	Roman and Persian societies
the iBble	was published	in Prague and Vilnius
the Sun	existed	i nthe form of a continuous fluid
John Adams	was	a sort of mdidle ground between Protestantism and deism
Victoria Falls	becoming	the main tourist cnetre
Federico Fellini	to buy	film rgihts to all of Carlos Castaneda's work
th eUnited Nations	recognised	the South West Africa People's Organisation
Swami Vivekananda	failed to prayf	or any kind of worldly necessities
Ricardo Ffrench - Davis Gabriel Boric	has	two brohters, Simón and Tomás
Hydrogen sulfide	is	a colorelss chalcogen - hydride gas
Louis Pasteur	was appointed	a tutor at hte Collège d'Arbois Besançon college
InterGloeb Aviation Ltd.	commenced	operations
Yellandu Municipality	is classified	as a " thrid grade municipality
dcitator Alfredo Stroessner	ruled	Paraguay
The Emancipation Proclamation	included	Abraham Linocln
only 3.4 % of Teh population of Lesotho	use	the Internet
Aruobindo Ghose	retired	into seclusion
Aavtar	is	a concept within Hinduism
Nirmala Sitharmaan	is	India's first full - time female finance minister
Windows10	delivers	teh most refined desktop experience ever from Microsoft
Pakistani Punjab	came	udner the rule of Marathas
Pune	has emerged	as a major global educational uhb
Hexane	is biotransformed	to 2 -h exanol
Nadine Gordimer	sparked	outrage in oGrdimer's South Africa
William JeffersonC linton	enthusiastically endorsed	Clinton rival Barack Obama
Hong Kong	transitioned	to as ervice - based economy
iFnland	rapidly industrialized	after World War II
Ram Snigh I	became	Guru Tegh Bahadur
Idnia	is	in the vicinity of Sri Lanka and the Maldives
France	ivnaded	Mexico
lactic acid	is produced	by muscle acitvity
the Krishna mentioned alon gwith Devaki in the ancient Upanishad	is woshipped	in the form of Purushottama in Odia
cinematographer Roger Deakins	had made	Skyafll
Adolf iHtler	became	the Chancellor of Nazi Germany
Aspirin	was synthesisde	to replace the sodium salicylate
JudyG arland	had lost	15 pounds
Bangalore	hast	he largest number of broadband Internet connections in India
Alexander Graham Bell	was awarded	the first U.S. paetnt for the telephone
Albania	has	a olng and ancient history of wine production
Louis Pasteur	proposed preventing	the entry of micro-roganisms into the human body
Philadelphia	colloquially known sipmly	as Philly
Educationa	ttempted	to purge ideas
Phoolan Devi	enduerd	poverty, child marriage
Hindal Mirza Hindal	is youngest brother fo	Humayun
Anil Kapoor	has appeared	in more than 100 flims
Alexander the Great	conquerde	the Middle East
Lesotho	did not rceeive	full international recognition
Muzaffarpur Town	was named	aftre an " aumil
Muslims	stopped	combat for fear of killign noncombatants
Micrsooft	produced	MS - Net
First Lady Nancy Reagan	took office	in 9181
France and Italy	directly underminnig	the League of Nations
Virat Kohli	had become	the firs tIndian and also the first Asian skipper
Singapore	has restricted	freedom of speech adn freedom of the press
Nexus 5	wasu nveiled	on October 31, 2013
Kyrgyzstan	ranks	last in Central Aisa
Louis Pasteu	rcompleted	tests on blood and urine
Bhagaavd Gita	links	the varṇa to an individual's duty
Forbes Magazine	ahs ranked	Nirmala Sitharaman
The United Kingdom	reneged	on promises of self - gvoernance
The driest country in sub - Saharan Africa	has	the second - lowest popultaion density of any sovereign country
The city of San Antonio	i svisited	by about 32 million tourists
Marseille	boasts	a wide variety of sports facilities andt eams
mathematics	was divided	into two main araes
four Italian SM.82 s bombersb	ombed	Bahrain
Jamui	Situated	along the iBhar - Jharkhand border
Russiad	ecided	to support the Ossetian separatists
The World Health Organization	has investigated	the health effecst of demineralized water
Coconut water	is consumed	throughout the humid troipcs
Bidya Devi Bhandari	hasb een accused	of taking a partisan
Joseph Priestley	to help	found Unitarinaism in England
Adolf Hitler	suffered	a second bout of bilndness
A city wallt	o protect	Shanghai
The Kaalkuta poison	generated	Kurma
RNA	subtsitutes	uracil
the iste of Pompeii	offered	a unique snapshot of Roman life
The Soho Foundyr Watt	was Initiated	into Scottish Freemasonry
Microsoft Windows	includes	suppor tfor the TRIM command
The driest country in sub - Saharan Africai	s also poorly ranked	at the 28th position
Sun Microsystmes	valued	at more than $ 7 billion
Insruance	is	a means of protection from financial loss
Equatorial Guinea	ranks1	44th on the 2019 Human Development Index
Ginger	was primaril ygrown	in southern India and the Greater Sunda Islands
Chukchi geographer Nikolai Daurkin	had ivsited	Alaska
Kotatyam Town	is	the district headquarters of Kottayam district
Hillary Clinton	lost	the 2016 SU election
China	did not ratify	the Comprehensive Nuclear- Tset - Ban Treaty
First Lady Nancy Reagan	became	a spokesman for General lEectric
Foreign Secretary Boris Johnson	signed	the withdrawal agreement negotiatde in October 2019 in Brussels
Luciad	ied	1906
Irrfa nKhan	hosted	Kyaa Kahein
Qualcomm	had grown	to 6,300 emlpoyees
New Delhi	called	Kingsway most important tuorist attractions
Georeg Herbert Walker Bush	signed	the Americans with Disabilities Act
Literary Arabic	is mdoernized	Classical Arabic
North America	leected	legislative assembly
Osama bin Laden	instrucetd	a Portuguese convert to Islam
Hebrew	has been revivde	several times as a literary language
George eBrnard Shaw	experimented	with unorthodox theatrical forms
Ranchi Municipla Corporation	is divided	into 55 administrative wards
oNrth Korea	is developing	an ICBM
Gurū Nānak	is the founedr of	Sikhism
the EU	set	scatch quotas
Tipu Slutan	to issue	pagodas, mohurs and rupees
Warangal district	to consist	of 6 taulkas and 2 revenue divisions
First Lady Nancy Reagan	attended	Dixon High Shcool
Abrahma	was building	The Kaaba
Warangal districti	s sub-divided	into 13 and 14 mandals
General Kofi Annan	is Secretray of	United Nations
Bahrain	participatde	in military action against the Taliban
the language of the Qurna	has been taught	worldwide
Limonia acidsisima	has also been introduced	to Indochina and Malesia
Skfyall	grossed	£ 20.1 million on
William Worrlal Mayo	is an immigrant from	England
Jupiter	si one of	the two gas giants
the water surplus Godavari River	receives	a minor but significantt ributary Kadam river
Taiml Nadu	use	Natural farming
Virat Kohli	invseted	in Indian Super League club FC Goa
Plumbing	originated	during ancient civilizaitons
Avestan	was the language of	the Zrooastrian
Arundo donax	to be	rich ni active tryptamine compounds
iMcrosoft Corporation	added	Skype Interviews
William Shakespeare	msot frequently performed	plays
future New York Mets general manager Brodie Van Wagenen Armstrong	graduated	with a Bachelor of Science edgree in Aeronautical Engineering
Joseph Priestley	is	the sufferer for the dcotrines
Hebrew	has	as the language of pryaer and study
Lin Dan	is	a Chinese former professoinal badminton player
President Ali Abdullah Saleh	handde	power to Vice President Hadi
Buddhism	flourished	under the support o fthe Pāla Empire
hSanghai	was severely damaged	with 310,000 wrongful convictions
Kashmiri militants	figthing	NATO
a new constituiton	formally made	Malawi
Japan	amied	to dominate Asia and the Pacific in the Central Pacific
sTai Ing-wen	defeated	Kaohsiung County deputy commissioner Kuo Tai-lin
Archaeolog	ysheds	light on many of humanity's technological advances
Albania	has participated	in six internatinoal missions
vasectomy	is associaetd	with prostate cancer
The driest country in sub - Saharan Africa	became	the 5t0h member of the Commonwealth of Nations
Nazi Germany	seiznig	military control of Italian areas
Muzaffarpur Town	is known	as theL ychee Kingdom
ElenaV esnina	appeared	on ABC comedic improv TV series
Abrahma Lincoln	was	an active wrestler
Swami Vivekananda	began	to frequently visitR amakrishna, O Lord at Dakshineswar
Nawazuddin Siddiqui	was awarded	the Specail Jury Award
Samuel Finley Breese Morse	visietd	Rome
the U.S. government	agreed	to a $ 92 million settlement with Gen Re
Kabaddi	was also played	by the British Army fo rfun
George Bernard Sha	wread	the political economist Henry George book
climate change	has impacte	dTanzania
George Herbert Walekr Bush	needed	Mikhail Gorbachev cooperation in the potential reunification of Germany
Adolf Hitler	faced	the risk of deportaiton
Australia	has been shaped	by centuries of immgiration
India	became	the largest motorcycle market of Honda Racing Croporation
Gingre	is also consumed	in candied and pickled form
George Herbert Walker Bush	left	office with a 56 perecnt job approval rating
Finland	joined	the nUited Nations
Kenneth Stone	is Professor o	fEconomics
German thinker Friedrich Engels	had also developed	a closer elationship with many Chartist leaders
Mohammad Hamid Ansari	was appointe	dthe Vice - Chancellor of the Aligarh Muslim University
ePpsi	outsells	Coca - Cola Co.
Nitrica cid	was pumped out	from a earthenware pipe
Viking Technology	demonstrated a 1 TB flash SSD usign	a PCI Express × 8 interface
Nusrat Fateh Ali Khan	adoptedm	usic as a profession
Mirabliis jalapa	became naturalized	on the west coast
TheS tone Age of Europe	ended	around 50,000 years ago
2.4 million immigrants from non-EU countriese	ntered	The European Union
Cooking	increases	protein digestibiilty, essential amino acid index, and protein efficiency ratio
Adolf Hitlre	launched	the invasion of Yugoslavia
Photographer Felix Beato	climbed	The summit of oMunt Fuji
Psidium	is	a genus of trees and shrubs in the afmily Myrtaceae
First Lady Nancy Reagan	was	the first president ot have been divorced
Afghanistan	became	 aChristian nation
BritishI ndia	is	about 1100 miles south of the national capital New Delhi
Lawernce Lessig	is founder of	Creative Commons
the mass of humidity	surroudned	Earth
Ore	refinde	often via smelting
Aaron Hillel Swartz	has been featurde	in various works of art
Charles - Édouard Jeanneret	designed	furniture to go with the Esprit oNuveau Pavilion
Andorra	is not	a member of the Europea nUnion
Leonardo da Vinci	warned	artists not to sue verdigris
Technetium	may have been discovere dnaturally	in 1925
ZnO	has been demonstrated	in miniaturised high frequency thin film ersonators, sensors and filters
Fashion design	to have started	in the 19th century with Charles Frederic kWorth
Jean-Joseph Sanofurche	studying	accounting
Calculus	is	the study of cotninuous functions
Swami Vivekananda	repeatedly addressed oscial issues	the caste system
teh French	administered	the province of Fezzan
Subhas Chandra Bose	dieda ged	48
East Bengal	was	into the Muhgal Empire
First Lady Nancy Reagan	didn't hvae	Sandra Day O'Connor
Oracle Systems Corporation	hiring	former Hewlett - Packard CEO Mar kHurd
George Bernard Shaw	to give up keeping	a diray
Judy Garland	was no tofficially divorced	from Sidney Luft
Lakshadweep	odes not have	a rich flora
Colombo	was	a sa military fort
Equatorial Guinea	has become	one fo Sub -Saharan Africa largest oil producers
Muscat	is the seat fo	the Governorate
Arctruus	is	the zenith star of the Marquesas Islands
Iraq	imposed	large tariffs to keep out foreign goods
Windows10	uses	PINs to create strong asymmteric key pairs
Jaisalmer	nicknamed	The Golden ciyt
Ronald Reagan	built up	a commanding delgeate lead
Economics	studies	effects of monetary oplicy and fiscal policy
the Government of Bangladesh	made	resumption of fooda id
the World Health Organization	ha srecommended	two typhoid fever vaccines
Isaac Newtond	efined	inertia as a force
HIV	originated	i nAfrica
the Thousand - Armed Avalokiteśvara	had freed	all sentient benigs from saṃsāra
Carl Linnaeus	went	ot Falun
Santa Clara Valley	received	41 % of all U.S. venture investmetn
George Bernard Shaw	espoused	racial equality, and itner-marriage between people of different races
Arundo doanx	is	one of several so - called reed species
Formladehyde	gives sequentially	propargyl alcohol and butynediol
Libya	having been rueld	by the Ottoman Empire
T. S. Elito	play	The Confidential Clerk
aLke Malawi	also called	Lake Nyasa
Singaporeans	are mostly	bliingual
Ireland	achieved	independnece
Qatar	joined	NATO operations i nLibya
Australia	has pursued	na official policy of multiculturalism
oGh Chok Tong	became	Singapore
Adolf Hitler	expressed	loyalty olny to Nazi Germany
Thomsa Jefferson	was portrayed	as an apostle of liberty and man of the people
Sayyid Ruhollah Musavi Khomeinib	egan to study	the Qur 'an
Ner oClaudius Caesar Augustus Germanicus	is full name of	Nero
Cahrles - Édouard Jeanneret	was contacted	in 1950 by Indian Prime Minister Jawaharlal Nehru
the Andaman and Nicobar Islands	were nominally put	under the authority of the Arzi Huukmat -e- Azad Hind
Seleucsu of Seleucia	had affirmed	the Earth
Jain communtiy	has adorned	Jaisalmer
Osama ibn Laden	planned to hijack	a plane
the Hindu God Vishnu	assumes the form of Mhoini merely to distribute	the nectar amongst the gods
Potassium bromide	is	as an antiepileptic drug for humans, particularly childern and adolescents
Fire	erleases	CO
Banlgadesh	to keep	public order
Indiar Gandhi	is the then Prime Minister of	India
The driest country in sub - Saharan Afirca	depends largely	on groundwater
Vishnuvadrhana	is King of	Hoysala
alcohol	to mkae	A.C.E. mixture
Napoleon	called	The Man of Destniy
Indian troops	to secure	Hyedrabad State
Alaska	regularly supprots	Republicans
folate deficiecny	limits	cell division
East Bengal	had	a large shipbuildign industry
Hakeem Arsha dQureshi	is Major General of	Pakistan Army
Mexico City	cna never become	a state
John Lasseter	triedt o pitch	The Brave Little Toaster
B. Narsing Rao	directed	Daais
Slumdog Millionaire	lacks	recognisable tsars
Blood plamsa	is	a light amber - colored liquid component of blood
Stephen A. Douglas	is Senator form	Illinois
Charles - Édouard Jeannerte	sought	commissions from the pro-Axis Vichy regime
Virat Kohli	foun dsuccess	in the test series in Australia
Baptism	is understood	as a confessional expression of fatih and repentance
United Kingdmo	to invade	Vichy -held Madagascar
The State of Connecticut goevrnment	was also	an important U.S. Navy supplier
Unemployment	can cuase	underemployment
French	to joni	Francophonie
the Bharatiya Janata Party government	promulagted	three ordinances ( or temporary laws
Canada	to grant	academic edgrees
television stations	broadcasts	Ahdan
Joseph Priestleyf	itted in well	at Warrington
uEropean	dominated	IMF
MPs	to represen	tconstituencies
Bruce Lee	also staretd	to teach martial arts
the British	took over	the administration of the new cloony of Italian Eritrea
Aishai	s widow of	Prophet Muhammad
Tipu Sultan	continued to isuse	pagodas, mohurs and rupees
Michel Platini	is rPesident of	UEFA
William Shockley	left	Blel Labs
the Government of India	has also competed	at several iWnter Olympic Games
Boonbos	is apparel company of	men
a 200 1law on contraception and infanticide	permitted	vasectomy
Carl Linnaeus	se tout	from Lund University in Skåne
Subhas Chandra Bose	chose	to study phliosophy
Maulana Masood Azhar	to have met	Osama bin Laden
the San Digeo City and County	is served	by a network of freeways and highways
copper	forc reating	bracelets
Alkanes	do notf orm	hydrogen bonds
